county,precinct,office,district,party,candidate,absentee_votes,early_voting,election_day,votes
Harrison,1,Straight Party,,,Republican Party,30,375,78,483
Harrison,1,Straight Party,,,Democratic Party,18,177,48,243
Harrison,1,Straight Party,,,Libertarian Party,1,4,2,7
Harrison,1,Straight Party,,,Green Party,0,2,0,2
Harrison,1,President,,Republican,Donald J. Trump / Mike Pence,47,793,143,983
Harrison,1,President,,Democratic,Hillary Clinton / Tim Kaine,34,342,90,466
Harrison,1,President,,Libertarian,Gary Johnson / William Weld,0,11,10,21
Harrison,1,President,,Green,Jill Stein / Ajamu Baraka,0,6,4,10
Harrison,1,President,,,Darrell L. Castle / Scott N. Bradley (W),0,0,1,1
Harrison,1,President,,,Scott Cubbler / Michael Rodriguez (W),0,0,0,0
Harrison,1,President,,,Cherunda Fox / Roger Kushner (W),0,0,0,0
Harrison,1,President,,,Tom Hoefling / Steve Schulin (W),0,1,0,1
Harrison,1,President,,,Laurence Kotlikoff / Edward Leamer (W),0,0,0,0
Harrison,1,President,,,Jonathan Lee / Jeffrey Erskine (W),0,0,0,0
Harrison,1,President,,,Michael A. Maturen / Juan A. Munoz (W),0,0,0,0
Harrison,1,President,,,Evan McMullin / Nathan Johnson (W),0,4,4,8
Harrison,1,President,,,Monica Moorehead / Lamon Lilly (W),0,0,0,0
Harrison,1,President,,,Robert Morrow / Todd Sanders (W),0,0,0,0
Harrison,1,President,,,Emidio Soltysik / Angela Walker (W),0,0,0,0
Harrison,1,President,,,Dale Steffes / Paul E. Case (W),0,0,0,0
Harrison,1,President,,,Tony Valdivia / Aaron Barriere (W),0,0,0,0
Harrison,1,U.S. House,1,Republican,Louie Gohmert,51,770,153,974
Harrison,1,U.S. House,1,Democratic,Shirley J. McKellar,30,304,84,418
Harrison,1,U.S. House,1,Libertarian,Phil Gray,1,15,9,25
Harrison,1,U.S. House,1,,Renee Culler (W),0,0,0,0
Harrison,1,Railroad Commissioner,,Republican,Wayne Christian,48,744,142,934
Harrison,1,Railroad Commissioner,,Democratic,Grady Yarbrough,32,315,86,433
Harrison,1,Railroad Commissioner,,Libertarian,Mark Miller,0,28,12,40
Harrison,1,Railroad Commissioner,,Green,Martina Salinas,0,11,2,13
Harrison,1,"Justice, Supreme Court, Place 3",,,Debra Lehrmann,47,740,139,926
Harrison,1,"Justice, Supreme Court, Place 3",,,Mike Westergren,33,297,86,416
Harrison,1,"Justice, Supreme Court, Place 3",,,Kathie Glass,1,17,12,30
Harrison,1,"Justice, Supreme Court, Place 3",,,Rodolfo Rivera Munoz,0,9,7,16
Harrison,1,"Justice, Supreme Court, Place 5",,,Paul Green,47,737,149,933
Harrison,1,"Justice, Supreme Court, Place 5",,,Dori Contreras Garza,31,294,80,405
Harrison,1,"Justice, Supreme Court, Place 5",,,Tom Oxford,1,16,8,25
Harrison,1,"Justice, Supreme Court, Place 5",,,Charles E. Waterbury,0,8,4,12
Harrison,1,"Justice, Supreme Court, Place 9",,,Eva Guzman,47,720,143,910
Harrison,1,"Justice, Supreme Court, Place 9",,,Savannah Robinson,30,302,87,419
Harrison,1,"Justice, Supreme Court, Place 9",,,Don Fulton,2,16,11,29
Harrison,1,"Justice, Supreme Court, Place 9",,,Jim Chisholm,0,15,4,19
Harrison,1,"Judge, Court of Criminal Appeals, Place 2",,,Mary Lou Keel,49,736,144,929
Harrison,1,"Judge, Court of Criminal Appeals, Place 2",,,"Lawrence ""Larry"" Meyers",30,298,87,415
Harrison,1,"Judge, Court of Criminal Appeals, Place 2",,,Mark Ash,1,16,9,26
Harrison,1,"Judge, Court of Criminal Appeals, Place 2",,,Adam King Blackwell Reposa,0,6,3,9
Harrison,1,"Judge, Court of Criminal Appeals, Place 5",,,Scott Walker,48,729,144,921
Harrison,1,"Judge, Court of Criminal Appeals, Place 5",,,Betsy Johnson,29,303,89,421
Harrison,1,"Judge, Court of Criminal Appeals, Place 5",,,"William Bryan Strange, III",1,18,7,26
Harrison,1,"Judge, Court of Criminal Appeals, Place 5",,,Judith Sanders-Castro,0,8,3,11
Harrison,1,"Judge, Court of Criminal Appeals, Place 6",,,Michael E. Keasler,46,735,146,927
Harrison,1,"Judge, Court of Criminal Appeals, Place 6",,,Robert Burns,33,298,87,418
Harrison,1,"Judge, Court of Criminal Appeals, Place 6",,,Mark W. Bennett,1,27,9,37
Harrison,1,"Member, State Board of Education, District 9",,,Keven M. Ellis,48,741,149,938
Harrison,1,"Member, State Board of Education, District 9",,,Amanda M. Rudolph,31,304,86,421
Harrison,1,"Member, State Board of Education, District 9",,,Anastasia Wilford,0,23,10,33
Harrison,1,State Senate,1,Republican,Bryan Hughes,51,829,188,1068
Harrison,1,State Representative,9,Republican,Chris Paddie,49,837,188,1074
Harrison,1,"Chief Justice, 6th Court of Appeals District",,,Josh Morriss,53,804,182,1039
Harrison,1,"District Judge, 71st Judicial District",,,Brad Morin,54,842,192,1088
Harrison,1,Sheriff,,,Tom McCool,55,840,190,1085
Harrison,1,Tax Assessor-Collector,,,Veronica King,54,850,188,1092
Harrison,1,"County Commissioner, Precinct No. 1",,,William D. Hatfield,55,812,180,1047
Harrison,1,"Constable, Precinct No. 1",,,John C. Hickey Jr,50,756,181,987
Harrison,2,Straight Party,,,Republican Party,9,129,63,201
Harrison,2,Straight Party,,,Democratic Party,55,321,119,495
Harrison,2,Straight Party,,,Libertarian Party,0,2,3,5
Harrison,2,Straight Party,,,Green Party,0,2,0,2
Harrison,2,President,,Republican,Donald J. Trump / Mike Pence,14,244,107,365
Harrison,2,President,,Democratic,Hillary Clinton / Tim Kaine,72,449,174,695
Harrison,2,President,,Libertarian,Gary Johnson / William Weld,0,5,8,13
Harrison,2,President,,Green,Jill Stein / Ajamu Baraka,0,4,3,7
Harrison,2,President,,,Darrell L. Castle / Scott N. Bradley (W),0,0,0,0
Harrison,2,President,,,Scott Cubbler / Michael Rodriguez (W),0,0,0,0
Harrison,2,President,,,Cherunda Fox / Roger Kushner (W),0,0,0,0
Harrison,2,President,,,Tom Hoefling / Steve Schulin (W),0,0,0,0
Harrison,2,President,,,Laurence Kotlikoff / Edward Leamer (W),0,0,0,0
Harrison,2,President,,,Jonathan Lee / Jeffrey Erskine (W),0,0,0,0
Harrison,2,President,,,Michael A. Maturen / Juan A. Munoz (W),0,0,0,0
Harrison,2,President,,,Evan McMullin / Nathan Johnson (W),2,2,5,9
Harrison,2,President,,,Monica Moorehead / Lamon Lilly (W),0,0,0,0
Harrison,2,President,,,Robert Morrow / Todd Sanders (W),0,0,0,0
Harrison,2,President,,,Emidio Soltysik / Angela Walker (W),0,0,0,0
Harrison,2,President,,,Dale Steffes / Paul E. Case (W),0,0,0,0
Harrison,2,President,,,Tony Valdivia / Aaron Barriere (W),0,0,0,0
Harrison,2,U.S. House,1,Republican,Louie Gohmert,18,244,124,386
Harrison,2,U.S. House,1,Democratic,Shirley J. McKellar,68,439,167,674
Harrison,2,U.S. House,1,Libertarian,Phil Gray,0,4,2,6
Harrison,2,U.S. House,1,,Renee Culler (W),0,0,0,0
Harrison,2,Railroad Commissioner,,Republican,Wayne Christian,15,224,105,344
Harrison,2,Railroad Commissioner,,Democratic,Grady Yarbrough,73,434,169,676
Harrison,2,Railroad Commissioner,,Libertarian,Mark Miller,0,14,11,25
Harrison,2,Railroad Commissioner,,Green,Martina Salinas,0,13,7,20
Harrison,2,"Justice, Supreme Court, Place 3",,,Debra Lehrmann,15,231,112,358
Harrison,2,"Justice, Supreme Court, Place 3",,,Mike Westergren,72,433,168,673
Harrison,2,"Justice, Supreme Court, Place 3",,,Kathie Glass,0,11,6,17
Harrison,2,"Justice, Supreme Court, Place 3",,,Rodolfo Rivera Munoz,0,6,7,13
Harrison,2,"Justice, Supreme Court, Place 5",,,Paul Green,18,233,113,364
Harrison,2,"Justice, Supreme Court, Place 5",,,Dori Contreras Garza,69,431,168,668
Harrison,2,"Justice, Supreme Court, Place 5",,,Tom Oxford,0,9,8,17
Harrison,2,"Justice, Supreme Court, Place 5",,,Charles E. Waterbury,0,6,3,9
Harrison,2,"Justice, Supreme Court, Place 9",,,Eva Guzman,15,221,112,348
Harrison,2,"Justice, Supreme Court, Place 9",,,Savannah Robinson,70,440,170,680
Harrison,2,"Justice, Supreme Court, Place 9",,,Don Fulton,1,11,8,20
Harrison,2,"Justice, Supreme Court, Place 9",,,Jim Chisholm,0,8,2,10
Harrison,2,"Judge, Court of Criminal Appeals, Place 2",,,Mary Lou Keel,15,232,113,360
Harrison,2,"Judge, Court of Criminal Appeals, Place 2",,,"Lawrence ""Larry"" Meyers",72,438,171,681
Harrison,2,"Judge, Court of Criminal Appeals, Place 2",,,Mark Ash,0,9,7,16
Harrison,2,"Judge, Court of Criminal Appeals, Place 2",,,Adam King Blackwell Reposa,0,4,2,6
Harrison,2,"Judge, Court of Criminal Appeals, Place 5",,,Scott Walker,16,231,110,357
Harrison,2,"Judge, Court of Criminal Appeals, Place 5",,,Betsy Johnson,70,438,172,680
Harrison,2,"Judge, Court of Criminal Appeals, Place 5",,,"William Bryan Strange, III",1,6,7,14
Harrison,2,"Judge, Court of Criminal Appeals, Place 5",,,Judith Sanders-Castro,0,7,4,11
Harrison,2,"Judge, Court of Criminal Appeals, Place 6",,,Michael E. Keasler,15,227,112,354
Harrison,2,"Judge, Court of Criminal Appeals, Place 6",,,Robert Burns,72,439,173,684
Harrison,2,"Judge, Court of Criminal Appeals, Place 6",,,Mark W. Bennett,0,17,9,26
Harrison,2,"Member, State Board of Education, District 9",,,Keven M. Ellis,15,226,111,352
Harrison,2,"Member, State Board of Education, District 9",,,Amanda M. Rudolph,71,446,172,689
Harrison,2,"Member, State Board of Education, District 9",,,Anastasia Wilford,0,11,9,20
Harrison,2,State Senate,1,Republican,Bryan Hughes,25,324,150,499
Harrison,2,State Representative,9,Republican,Chris Paddie,23,336,153,512
Harrison,2,"Chief Justice, 6th Court of Appeals District",,,Josh Morriss,23,315,150,488
Harrison,2,"District Judge, 71st Judicial District",,,Brad Morin,25,333,154,512
Harrison,2,Sheriff,,,Tom McCool,25,361,160,546
Harrison,2,Tax Assessor-Collector,,,Veronica King,28,364,161,553
Harrison,2,"Constable, Precinct No. 2",,,Brant Moore,76,514,221,811
Harrison,3,Straight Party,,,Republican Party,11,28,5,44
Harrison,3,Straight Party,,,Democratic Party,70,437,174,681
Harrison,3,Straight Party,,,Libertarian Party,0,1,1,2
Harrison,3,Straight Party,,,Green Party,0,1,1,2
Harrison,3,President,,Republican,Donald J. Trump / Mike Pence,13,56,10,79
Harrison,3,President,,Democratic,Hillary Clinton / Tim Kaine,91,643,253,987
Harrison,3,President,,Libertarian,Gary Johnson / William Weld,0,3,3,6
Harrison,3,President,,Green,Jill Stein / Ajamu Baraka,0,2,0,2
Harrison,3,President,,,Darrell L. Castle / Scott N. Bradley (W),0,0,0,0
Harrison,3,President,,,Scott Cubbler / Michael Rodriguez (W),0,0,0,0
Harrison,3,President,,,Cherunda Fox / Roger Kushner (W),0,1,0,1
Harrison,3,President,,,Tom Hoefling / Steve Schulin (W),0,0,0,0
Harrison,3,President,,,Laurence Kotlikoff / Edward Leamer (W),0,0,0,0
Harrison,3,President,,,Jonathan Lee / Jeffrey Erskine (W),0,0,0,0
Harrison,3,President,,,Michael A. Maturen / Juan A. Munoz (W),0,0,0,0
Harrison,3,President,,,Evan McMullin / Nathan Johnson (W),0,0,0,0
Harrison,3,President,,,Monica Moorehead / Lamon Lilly (W),0,0,0,0
Harrison,3,President,,,Robert Morrow / Todd Sanders (W),0,0,0,0
Harrison,3,President,,,Emidio Soltysik / Angela Walker (W),0,0,0,0
Harrison,3,President,,,Dale Steffes / Paul E. Case (W),0,0,0,0
Harrison,3,President,,,Tony Valdivia / Aaron Barriere (W),0,0,0,0
Harrison,3,U.S. House,1,Republican,Louie Gohmert,15,74,15,104
Harrison,3,U.S. House,1,Democratic,Shirley J. McKellar,87,597,239,923
Harrison,3,U.S. House,1,Libertarian,Phil Gray,0,9,6,15
Harrison,3,U.S. House,1,,Renee Culler (W),0,0,0,0
Harrison,3,Railroad Commissioner,,Republican,Wayne Christian,13,57,10,80
Harrison,3,Railroad Commissioner,,Democratic,Grady Yarbrough,87,600,236,923
Harrison,3,Railroad Commissioner,,Libertarian,Mark Miller,1,14,6,21
Harrison,3,Railroad Commissioner,,Green,Martina Salinas,0,9,6,15
Harrison,3,"Justice, Supreme Court, Place 3",,,Debra Lehrmann,12,56,13,81
Harrison,3,"Justice, Supreme Court, Place 3",,,Mike Westergren,89,597,234,920
Harrison,3,"Justice, Supreme Court, Place 3",,,Kathie Glass,1,13,6,20
Harrison,3,"Justice, Supreme Court, Place 3",,,Rodolfo Rivera Munoz,0,11,5,16
Harrison,3,"Justice, Supreme Court, Place 5",,,Paul Green,13,58,13,84
Harrison,3,"Justice, Supreme Court, Place 5",,,Dori Contreras Garza,88,603,238,929
Harrison,3,"Justice, Supreme Court, Place 5",,,Tom Oxford,1,13,5,19
Harrison,3,"Justice, Supreme Court, Place 5",,,Charles E. Waterbury,0,4,1,5
Harrison,3,"Justice, Supreme Court, Place 9",,,Eva Guzman,12,60,13,85
Harrison,3,"Justice, Supreme Court, Place 9",,,Savannah Robinson,89,603,236,928
Harrison,3,"Justice, Supreme Court, Place 9",,,Don Fulton,1,12,8,21
Harrison,3,"Justice, Supreme Court, Place 9",,,Jim Chisholm,0,5,1,6
Harrison,3,"Judge, Court of Criminal Appeals, Place 2",,,Mary Lou Keel,14,61,12,87
Harrison,3,"Judge, Court of Criminal Appeals, Place 2",,,"Lawrence ""Larry"" Meyers",85,599,238,922
Harrison,3,"Judge, Court of Criminal Appeals, Place 2",,,Mark Ash,1,11,3,15
Harrison,3,"Judge, Court of Criminal Appeals, Place 2",,,Adam King Blackwell Reposa,0,8,3,11
Harrison,3,"Judge, Court of Criminal Appeals, Place 5",,,Scott Walker,13,53,9,75
Harrison,3,"Judge, Court of Criminal Appeals, Place 5",,,Betsy Johnson,86,609,245,940
Harrison,3,"Judge, Court of Criminal Appeals, Place 5",,,"William Bryan Strange, III",2,9,3,14
Harrison,3,"Judge, Court of Criminal Appeals, Place 5",,,Judith Sanders-Castro,0,7,1,8
Harrison,3,"Judge, Court of Criminal Appeals, Place 6",,,Michael E. Keasler,13,54,10,77
Harrison,3,"Judge, Court of Criminal Appeals, Place 6",,,Robert Burns,87,612,241,940
Harrison,3,"Judge, Court of Criminal Appeals, Place 6",,,Mark W. Bennett,1,10,4,15
Harrison,3,"Member, State Board of Education, District 9",,,Keven M. Ellis,14,54,10,78
Harrison,3,"Member, State Board of Education, District 9",,,Amanda M. Rudolph,87,612,238,937
Harrison,3,"Member, State Board of Education, District 9",,,Anastasia Wilford,0,10,10,20
Harrison,3,State Senate,1,Republican,Bryan Hughes,22,179,74,275
Harrison,3,State Representative,9,Republican,Chris Paddie,21,187,75,283
Harrison,3,"Chief Justice, 6th Court of Appeals District",,,Josh Morriss,21,172,70,263
Harrison,3,"District Judge, 71st Judicial District",,,Brad Morin,22,203,76,301
Harrison,3,Sheriff,,,Tom McCool,26,217,82,325
Harrison,3,Tax Assessor-Collector,,,Veronica King,27,248,87,362
Harrison,3,"Constable, Precinct No. 2",,,Brant Moore,97,628,239,964
Harrison,4,Straight Party,,,Republican Party,13,259,56,328
Harrison,4,Straight Party,,,Democratic Party,21,197,62,280
Harrison,4,Straight Party,,,Libertarian Party,0,1,2,3
Harrison,4,Straight Party,,,Green Party,0,1,0,1
Harrison,4,President,,Republican,Donald J. Trump / Mike Pence,24,449,112,585
Harrison,4,President,,Democratic,Hillary Clinton / Tim Kaine,33,301,98,432
Harrison,4,President,,Libertarian,Gary Johnson / William Weld,0,8,5,13
Harrison,4,President,,Green,Jill Stein / Ajamu Baraka,0,4,0,4
Harrison,4,President,,,Darrell L. Castle / Scott N. Bradley (W),0,0,0,0
Harrison,4,President,,,Scott Cubbler / Michael Rodriguez (W),0,0,0,0
Harrison,4,President,,,Cherunda Fox / Roger Kushner (W),0,0,0,0
Harrison,4,President,,,Tom Hoefling / Steve Schulin (W),0,0,0,0
Harrison,4,President,,,Laurence Kotlikoff / Edward Leamer (W),0,0,0,0
Harrison,4,President,,,Jonathan Lee / Jeffrey Erskine (W),0,0,0,0
Harrison,4,President,,,Michael A. Maturen / Juan A. Munoz (W),0,0,0,0
Harrison,4,President,,,Evan McMullin / Nathan Johnson (W),0,2,0,2
Harrison,4,President,,,Monica Moorehead / Lamon Lilly (W),0,0,0,0
Harrison,4,President,,,Robert Morrow / Todd Sanders (W),0,0,0,0
Harrison,4,President,,,Emidio Soltysik / Angela Walker (W),0,0,0,0
Harrison,4,President,,,Dale Steffes / Paul E. Case (W),0,0,0,0
Harrison,4,President,,,Tony Valdivia / Aaron Barriere (W),0,0,0,0
Harrison,4,U.S. House,1,Republican,Louie Gohmert,21,455,108,584
Harrison,4,U.S. House,1,Democratic,Shirley J. McKellar,32,290,99,421
Harrison,4,U.S. House,1,Libertarian,Phil Gray,0,11,4,15
Harrison,4,U.S. House,1,,Renee Culler (W),0,1,0,1
Harrison,4,Railroad Commissioner,,Republican,Wayne Christian,20,441,105,566
Harrison,4,Railroad Commissioner,,Democratic,Grady Yarbrough,30,286,93,409
Harrison,4,Railroad Commissioner,,Libertarian,Mark Miller,2,11,8,21
Harrison,4,Railroad Commissioner,,Green,Martina Salinas,1,12,4,17
Harrison,4,"Justice, Supreme Court, Place 3",,,Debra Lehrmann,21,430,108,559
Harrison,4,"Justice, Supreme Court, Place 3",,,Mike Westergren,28,293,87,408
Harrison,4,"Justice, Supreme Court, Place 3",,,Kathie Glass,3,17,9,29
Harrison,4,"Justice, Supreme Court, Place 3",,,Rodolfo Rivera Munoz,0,7,5,12
Harrison,4,"Justice, Supreme Court, Place 5",,,Paul Green,20,442,109,571
Harrison,4,"Justice, Supreme Court, Place 5",,,Dori Contreras Garza,29,294,92,415
Harrison,4,"Justice, Supreme Court, Place 5",,,Tom Oxford,2,9,7,18
Harrison,4,"Justice, Supreme Court, Place 5",,,Charles E. Waterbury,0,3,1,4
Harrison,4,"Justice, Supreme Court, Place 9",,,Eva Guzman,22,428,112,562
Harrison,4,"Justice, Supreme Court, Place 9",,,Savannah Robinson,28,296,89,413
Harrison,4,"Justice, Supreme Court, Place 9",,,Don Fulton,0,12,5,17
Harrison,4,"Justice, Supreme Court, Place 9",,,Jim Chisholm,0,8,3,11
Harrison,4,"Judge, Court of Criminal Appeals, Place 2",,,Mary Lou Keel,20,436,106,562
Harrison,4,"Judge, Court of Criminal Appeals, Place 2",,,"Lawrence ""Larry"" Meyers",30,294,89,413
Harrison,4,"Judge, Court of Criminal Appeals, Place 2",,,Mark Ash,1,15,7,23
Harrison,4,"Judge, Court of Criminal Appeals, Place 2",,,Adam King Blackwell Reposa,0,4,3,7
Harrison,4,"Judge, Court of Criminal Appeals, Place 5",,,Scott Walker,19,432,108,559
Harrison,4,"Judge, Court of Criminal Appeals, Place 5",,,Betsy Johnson,30,302,92,424
Harrison,4,"Judge, Court of Criminal Appeals, Place 5",,,"William Bryan Strange, III",1,8,3,12
Harrison,4,"Judge, Court of Criminal Appeals, Place 5",,,Judith Sanders-Castro,1,6,4,11
Harrison,4,"Judge, Court of Criminal Appeals, Place 6",,,Michael E. Keasler,20,436,108,564
Harrison,4,"Judge, Court of Criminal Appeals, Place 6",,,Robert Burns,31,299,93,423
Harrison,4,"Judge, Court of Criminal Appeals, Place 6",,,Mark W. Bennett,0,10,7,17
Harrison,4,"Member, State Board of Education, District 9",,,Keven M. Ellis,22,434,106,562
Harrison,4,"Member, State Board of Education, District 9",,,Amanda M. Rudolph,31,300,97,428
Harrison,4,"Member, State Board of Education, District 9",,,Anastasia Wilford,1,11,5,17
Harrison,4,State Senate,1,Republican,Bryan Hughes,31,530,145,706
Harrison,4,State Representative,9,Republican,Chris Paddie,31,537,145,713
Harrison,4,"Chief Justice, 6th Court of Appeals District",,,Josh Morriss,31,520,141,692
Harrison,4,"District Judge, 71st Judicial District",,,Brad Morin,33,543,150,726
Harrison,4,Sheriff,,,Tom McCool,35,556,153,744
Harrison,4,Tax Assessor-Collector,,,Veronica King,40,575,155,770
Harrison,4,"Justice of the Peace, Precinct No. 4 - Unexpired Term",,,Nancy Schnorbus George,38,570,158,766
Harrison,4,"Constable, Precinct No. 4",,,Darryl Griffin,32,528,143,703
Harrison,5,Straight Party,,,Republican Party,15,151,84,250
Harrison,5,Straight Party,,,Democratic Party,10,37,30,77
Harrison,5,Straight Party,,,Libertarian Party,0,2,3,5
Harrison,5,Straight Party,,,Green Party,0,0,0,0
Harrison,5,President,,Republican,Donald J. Trump / Mike Pence,25,299,179,503
Harrison,5,President,,Democratic,Hillary Clinton / Tim Kaine,15,64,52,131
Harrison,5,President,,Libertarian,Gary Johnson / William Weld,0,3,10,13
Harrison,5,President,,Green,Jill Stein / Ajamu Baraka,0,1,3,4
Harrison,5,President,,,Darrell L. Castle / Scott N. Bradley (W),0,0,0,0
Harrison,5,President,,,Scott Cubbler / Michael Rodriguez (W),0,0,0,0
Harrison,5,President,,,Cherunda Fox / Roger Kushner (W),0,0,0,0
Harrison,5,President,,,Tom Hoefling / Steve Schulin (W),0,0,0,0
Harrison,5,President,,,Laurence Kotlikoff / Edward Leamer (W),0,0,0,0
Harrison,5,President,,,Jonathan Lee / Jeffrey Erskine (W),0,0,0,0
Harrison,5,President,,,Michael A. Maturen / Juan A. Munoz (W),0,0,0,0
Harrison,5,President,,,Evan McMullin / Nathan Johnson (W),0,0,0,0
Harrison,5,President,,,Monica Moorehead / Lamon Lilly (W),0,0,0,0
Harrison,5,President,,,Robert Morrow / Todd Sanders (W),0,0,0,0
Harrison,5,President,,,Emidio Soltysik / Angela Walker (W),0,0,0,0
Harrison,5,President,,,Dale Steffes / Paul E. Case (W),0,0,0,0
Harrison,5,President,,,Tony Valdivia / Aaron Barriere (W),0,0,0,0
Harrison,5,U.S. House,1,Republican,Louie Gohmert,26,284,171,481
Harrison,5,U.S. House,1,Democratic,Shirley J. McKellar,14,68,59,141
Harrison,5,U.S. House,1,Libertarian,Phil Gray,0,9,10,19
Harrison,5,U.S. House,1,,Renee Culler (W),0,0,0,0
Harrison,5,Railroad Commissioner,,Republican,Wayne Christian,25,281,161,467
Harrison,5,Railroad Commissioner,,Democratic,Grady Yarbrough,14,66,52,132
Harrison,5,Railroad Commissioner,,Libertarian,Mark Miller,0,11,16,27
Harrison,5,Railroad Commissioner,,Green,Martina Salinas,1,0,5,6
Harrison,5,"Justice, Supreme Court, Place 3",,Republican,Debra Lehrmann,24,283,159,466
Harrison,5,"Justice, Supreme Court, Place 3",,Democratic,Mike Westergren,13,66,58,137
Harrison,5,"Justice, Supreme Court, Place 3",,Libertarian,Kathie Glass,0,9,12,21
Harrison,5,"Justice, Supreme Court, Place 3",,,Rodolfo Rivera Munoz,1,3,4,8
Harrison,5,"Justice, Supreme Court, Place 5",,Republican,Paul Green,23,284,164,471
Harrison,5,"Justice, Supreme Court, Place 5",,Democratic,Dori Contreras Garza,15,58,56,129
Harrison,5,"Justice, Supreme Court, Place 5",,Libertarian,Tom Oxford,0,12,12,24
Harrison,5,"Justice, Supreme Court, Place 5",,,Charles E. Waterbury,0,3,0,3
Harrison,5,"Justice, Supreme Court, Place 9",,,Eva Guzman,22,272,157,451
Harrison,5,"Justice, Supreme Court, Place 9",,,Savannah Robinson,14,64,57,135
Harrison,5,"Justice, Supreme Court, Place 9",,,Don Fulton,0,11,14,25
Harrison,5,"Justice, Supreme Court, Place 9",,,Jim Chisholm,2,7,3,12
Harrison,5,"Judge, Court of Criminal Appeals, Place 2",,,Mary Lou Keel,25,275,156,456
Harrison,5,"Judge, Court of Criminal Appeals, Place 2",,,"Lawrence ""Larry"" Meyers",13,66,57,136
Harrison,5,"Judge, Court of Criminal Appeals, Place 2",,,Mark Ash,0,7,17,24
Harrison,5,"Judge, Court of Criminal Appeals, Place 2",,,Adam King Blackwell Reposa,0,6,0,6
Harrison,5,"Judge, Court of Criminal Appeals, Place 5",,,Scott Walker,23,281,164,468
Harrison,5,"Judge, Court of Criminal Appeals, Place 5",,,Betsy Johnson,15,65,56,136
Harrison,5,"Judge, Court of Criminal Appeals, Place 5",,,"William Bryan Strange, III",0,4,10,14
Harrison,5,"Judge, Court of Criminal Appeals, Place 5",,,Judith Sanders-Castro,0,3,1,4
Harrison,5,"Judge, Court of Criminal Appeals, Place 6",,,Michael E. Keasler,24,271,156,451
Harrison,5,"Judge, Court of Criminal Appeals, Place 6",,,Robert Burns,14,70,58,142
Harrison,5,"Judge, Court of Criminal Appeals, Place 6",,,Mark W. Bennett,0,10,15,25
Harrison,5,"Member, State Board of Education, District 9",,,Keven M. Ellis,22,275,156,453
Harrison,5,"Member, State Board of Education, District 9",,,Amanda M. Rudolph,15,66,59,140
Harrison,5,"Member, State Board of Education, District 9",,,Anastasia Wilford,0,8,13,21
Harrison,5,State Senate,1,Republican,Bryan Hughes,26,300,187,513
Harrison,5,State Representative,9,Republican,Chris Paddie,26,301,189,516
Harrison,5,"Chief Justice, 6th Court of Appeals District",,,Josh Morriss,26,297,189,512
Harrison,5,"District Judge, 71st Judicial District",,,Brad Morin,25,300,194,519
Harrison,5,Sheriff,,,Tom McCool,28,310,191,529
Harrison,5,Tax Assessor-Collector,,,Veronica King,28,310,200,538
Harrison,5,"County Commissioner, Precinct No. 1",,,William D. Hatfield,28,299,187,514
Harrison,5,"Constable, Precinct No. 1",,,John C. Hickey Jr,26,295,190,511
Harrison,5,"Trustee, Place 3 Karnack",,,Lacy D. Warren,9,165,103,277
Harrison,5,"Trustee, Place 3 Karnack",,,Jimmy P. Theodos,5,97,70,172
Harrison,6,Straight Party,,,Republican Party,16,194,147,357
Harrison,6,Straight Party,,,Democratic Party,1,68,36,105
Harrison,6,Straight Party,,,Libertarian Party,0,0,0,0
Harrison,6,Straight Party,,,Green Party,0,1,0,1
Harrison,6,President,,Republican,Donald J. Trump / Mike Pence,32,415,318,765
Harrison,6,President,,Democratic,Hillary Clinton / Tim Kaine,3,116,63,182
Harrison,6,President,,Libertarian,Gary Johnson / William Weld,0,2,7,9
Harrison,6,President,,Green,Jill Stein / Ajamu Baraka,0,1,1,2
Harrison,6,President,,,Darrell L. Castle / Scott N. Bradley (W),0,0,2,2
Harrison,6,President,,,Scott Cubbler / Michael Rodriguez (W),0,0,0,0
Harrison,6,President,,,Cherunda Fox / Roger Kushner (W),0,0,0,0
Harrison,6,President,,,Tom Hoefling / Steve Schulin (W),0,0,0,0
Harrison,6,President,,,Laurence Kotlikoff / Edward Leamer (W),0,0,0,0
Harrison,6,President,,,Jonathan Lee / Jeffrey Erskine (W),0,0,0,0
Harrison,6,President,,,Michael A. Maturen / Juan A. Munoz (W),0,0,0,0
Harrison,6,President,,,Evan McMullin / Nathan Johnson (W),0,0,2,2
Harrison,6,President,,,Monica Moorehead / Lamon Lilly (W),0,0,0,0
Harrison,6,President,,,Robert Morrow / Todd Sanders (W),0,0,0,0
Harrison,6,President,,,Emidio Soltysik / Angela Walker (W),0,0,0,0
Harrison,6,President,,,Dale Steffes / Paul E. Case (W),0,0,0,0
Harrison,6,President,,,Tony Valdivia / Aaron Barriere (W),0,0,0,0
Harrison,6,U.S. House,1,Republican,Louie Gohmert,33,407,314,754
Harrison,6,U.S. House,1,Democratic,Shirley J. McKellar,2,110,60,172
Harrison,6,U.S. House,1,Libertarian,Phil Gray,0,7,12,19
Harrison,6,U.S. House,1,,Renee Culler (W),0,0,0,0
Harrison,6,Railroad Commissioner,,Republican,Wayne Christian,32,380,305,717
Harrison,6,Railroad Commissioner,,Democratic,Grady Yarbrough,3,110,62,175
Harrison,6,Railroad Commissioner,,Libertarian,Mark Miller,0,15,13,28
Harrison,6,Railroad Commissioner,,Green,Martina Salinas,0,8,2,10
Harrison,6,"Justice, Supreme Court, Place 3",,,Debra Lehrmann,31,388,297,716
Harrison,6,"Justice, Supreme Court, Place 3",,,Mike Westergren,3,109,64,176
Harrison,6,"Justice, Supreme Court, Place 3",,,Kathie Glass,0,12,16,28
Harrison,6,"Justice, Supreme Court, Place 3",,,Rodolfo Rivera Munoz,0,5,4,9
Harrison,6,"Justice, Supreme Court, Place 5",,,Paul Green,30,397,308,735
Harrison,6,"Justice, Supreme Court, Place 5",,,Dori Contreras Garza,3,108,57,168
Harrison,6,"Justice, Supreme Court, Place 5",,,Tom Oxford,1,6,13,20
Harrison,6,"Justice, Supreme Court, Place 5",,,Charles E. Waterbury,0,2,1,3
Harrison,6,"Justice, Supreme Court, Place 9",,,Eva Guzman,29,379,298,706
Harrison,6,"Justice, Supreme Court, Place 9",,,Savannah Robinson,4,114,62,180
Harrison,6,"Justice, Supreme Court, Place 9",,,Don Fulton,1,8,14,23
Harrison,6,"Justice, Supreme Court, Place 9",,,Jim Chisholm,0,8,3,11
Harrison,6,"Judge, Court of Criminal Appeals, Place 2",,,Mary Lou Keel,30,388,300,718
Harrison,6,"Judge, Court of Criminal Appeals, Place 2",,,"Lawrence ""Larry"" Meyers",3,110,70,183
Harrison,6,"Judge, Court of Criminal Appeals, Place 2",,,Mark Ash,2,9,10,21
Harrison,6,"Judge, Court of Criminal Appeals, Place 2",,,Adam King Blackwell Reposa,0,1,3,4
Harrison,6,"Judge, Court of Criminal Appeals, Place 5",,,Scott Walker,31,391,306,728
Harrison,6,"Judge, Court of Criminal Appeals, Place 5",,,Betsy Johnson,3,110,65,178
Harrison,6,"Judge, Court of Criminal Appeals, Place 5",,,"William Bryan Strange, III",0,6,11,17
Harrison,6,"Judge, Court of Criminal Appeals, Place 5",,,Judith Sanders-Castro,1,2,1,4
Harrison,6,"Judge, Court of Criminal Appeals, Place 6",,,Michael E. Keasler,31,380,304,715
Harrison,6,"Judge, Court of Criminal Appeals, Place 6",,,Robert Burns,3,115,62,180
Harrison,6,"Judge, Court of Criminal Appeals, Place 6",,,Mark W. Bennett,0,8,14,22
Harrison,6,"Member, State Board of Education, District 9",,,Keven M. Ellis,31,383,306,720
Harrison,6,"Member, State Board of Education, District 9",,,Amanda M. Rudolph,3,113,65,181
Harrison,6,"Member, State Board of Education, District 9",,,Anastasia Wilford,0,7,8,15
Harrison,6,State Senate,1,Republican,Bryan Hughes,32,416,338,786
Harrison,6,State Representative,9,Republican,Chris Paddie,32,418,332,782
Harrison,6,"Chief Justice, 6th Court of Appeals District",,,Josh Morriss,32,415,333,780
Harrison,6,"District Judge, 71st Judicial District",,,Brad Morin,32,428,330,790
Harrison,6,Sheriff,,,Tom McCool,34,433,342,809
Harrison,6,Tax Assessor-Collector,,,Veronica King,33,428,340,801
Harrison,6,"County Commissioner, Precinct No. 1",,,William D. Hatfield,33,407,317,757
Harrison,6,"Constable, Precinct No. 1",,,John C. Hickey Jr,33,410,312,755
Harrison,7,Straight Party,,,Republican Party,11,163,63,237
Harrison,7,Straight Party,,,Democratic Party,5,64,21,90
Harrison,7,Straight Party,,,Libertarian Party,0,0,1,1
Harrison,7,Straight Party,,,Green Party,0,1,0,1
Harrison,7,President,,Republican,Donald J. Trump / Mike Pence,18,304,103,425
Harrison,7,President,,Democratic,Hillary Clinton / Tim Kaine,8,113,34,155
Harrison,7,President,,Libertarian,Gary Johnson / William Weld,0,6,8,14
Harrison,7,President,,Green,Jill Stein / Ajamu Baraka,0,0,0,0
Harrison,7,President,,,Darrell L. Castle / Scott N. Bradley (W),0,1,0,1
Harrison,7,President,,,Scott Cubbler / Michael Rodriguez (W),0,0,0,0
Harrison,7,President,,,Cherunda Fox / Roger Kushner (W),0,0,0,0
Harrison,7,President,,,Tom Hoefling / Steve Schulin (W),0,0,0,0
Harrison,7,President,,,Laurence Kotlikoff / Edward Leamer (W),0,0,0,0
Harrison,7,President,,,Jonathan Lee / Jeffrey Erskine (W),0,0,0,0
Harrison,7,President,,,Michael A. Maturen / Juan A. Munoz (W),0,0,0,0
Harrison,7,President,,,Evan McMullin / Nathan Johnson (W),0,0,1,1
Harrison,7,President,,,Monica Moorehead / Lamon Lilly (W),0,0,0,0
Harrison,7,President,,,Robert Morrow / Todd Sanders (W),0,0,0,0
Harrison,7,President,,,Emidio Soltysik / Angela Walker (W),0,0,0,0
Harrison,7,President,,,Dale Steffes / Paul E. Case (W),0,0,0,0
Harrison,7,President,,,Tony Valdivia / Aaron Barriere (W),0,0,0,0
Harrison,7,U.S. House,1,Republican,Louie Gohmert,18,300,109,427
Harrison,7,U.S. House,1,Democratic,Shirley J. McKellar,8,109,29,146
Harrison,7,U.S. House,1,Libertarian,Phil Gray,0,11,6,17
Harrison,7,U.S. House,1,,Renee Culler (W),0,0,0,0
Harrison,7,Railroad Commissioner,,Republican,Wayne Christian,15,286,105,406
Harrison,7,Railroad Commissioner,,Democratic,Grady Yarbrough,9,112,28,149
Harrison,7,Railroad Commissioner,,Libertarian,Mark Miller,2,15,10,27
Harrison,7,Railroad Commissioner,,Green,Martina Salinas,0,4,1,5
Harrison,7,"Justice, Supreme Court, Place 3",,,Debra Lehrmann,16,286,103,405
Harrison,7,"Justice, Supreme Court, Place 3",,,Mike Westergren,8,108,30,146
Harrison,7,"Justice, Supreme Court, Place 3",,,Kathie Glass,0,16,11,27
Harrison,7,"Justice, Supreme Court, Place 3",,,Rodolfo Rivera Munoz,1,6,0,7
Harrison,7,"Justice, Supreme Court, Place 5",,,Paul Green,15,291,108,414
Harrison,7,"Justice, Supreme Court, Place 5",,,Dori Contreras Garza,10,102,26,138
Harrison,7,"Justice, Supreme Court, Place 5",,,Tom Oxford,0,18,10,28
Harrison,7,"Justice, Supreme Court, Place 5",,,Charles E. Waterbury,0,3,0,3
Harrison,7,"Justice, Supreme Court, Place 9",,,Eva Guzman,17,289,103,409
Harrison,7,"Justice, Supreme Court, Place 9",,,Savannah Robinson,8,106,29,143
Harrison,7,"Justice, Supreme Court, Place 9",,,Don Fulton,0,16,10,26
Harrison,7,"Justice, Supreme Court, Place 9",,,Jim Chisholm,0,4,1,5
Harrison,7,"Judge, Court of Criminal Appeals, Place 2",,,Mary Lou Keel,16,287,107,410
Harrison,7,"Judge, Court of Criminal Appeals, Place 2",,,"Lawrence ""Larry"" Meyers",9,111,29,149
Harrison,7,"Judge, Court of Criminal Appeals, Place 2",,,Mark Ash,0,13,6,19
Harrison,7,"Judge, Court of Criminal Appeals, Place 2",,,Adam King Blackwell Reposa,0,3,0,3
Harrison,7,"Judge, Court of Criminal Appeals, Place 5",,,Scott Walker,17,293,108,418
Harrison,7,"Judge, Court of Criminal Appeals, Place 5",,,Betsy Johnson,8,106,29,143
Harrison,7,"Judge, Court of Criminal Appeals, Place 5",,,"William Bryan Strange, III",0,11,6,17
Harrison,7,"Judge, Court of Criminal Appeals, Place 5",,,Judith Sanders-Castro,0,6,0,6
Harrison,7,"Judge, Court of Criminal Appeals, Place 6",,,Michael E. Keasler,16,294,105,415
Harrison,7,"Judge, Court of Criminal Appeals, Place 6",,,Robert Burns,9,108,28,145
Harrison,7,"Judge, Court of Criminal Appeals, Place 6",,,Mark W. Bennett,0,13,10,23
Harrison,7,"Member, State Board of Education, District 9",,,Keven M. Ellis,14,289,105,408
Harrison,7,"Member, State Board of Education, District 9",,,Amanda M. Rudolph,11,111,27,149
Harrison,7,"Member, State Board of Education, District 9",,,Anastasia Wilford,0,12,11,23
Harrison,7,State Senate,1,Republican,Bryan Hughes,17,329,116,462
Harrison,7,State Representative,9,Republican,Chris Paddie,17,333,117,467
Harrison,7,"Chief Justice, 6th Court of Appeals District",,,Josh Morriss,17,328,115,460
Harrison,7,"District Judge, 71st Judicial District",,,Brad Morin,16,334,119,469
Harrison,7,Sheriff,,,Tom McCool,17,339,117,473
Harrison,7,Tax Assessor-Collector,,,Veronica King,17,347,118,482
Harrison,7,"County Commissioner, Precinct No. 1",,,William D. Hatfield,17,331,115,463
Harrison,7,"Constable, Precinct No. 1",,,John C. Hickey Jr,16,316,112,444
Harrison,8,Straight Party,,,Republican Party,40,491,118,649
Harrison,8,Straight Party,,,Democratic Party,11,141,46,198
Harrison,8,Straight Party,,,Libertarian Party,0,0,0,0
Harrison,8,Straight Party,,,Green Party,0,1,1,2
Harrison,8,President,,Republican,Donald J. Trump / Mike Pence,54,966,233,1253
Harrison,8,President,,Democratic,Hillary Clinton / Tim Kaine,22,313,86,421
Harrison,8,President,,Libertarian,Gary Johnson / William Weld,4,18,10,32
Harrison,8,President,,Green,Jill Stein / Ajamu Baraka,0,5,1,6
Harrison,8,President,,,Darrell L. Castle / Scott N. Bradley (W),0,4,0,4
Harrison,8,President,,,Scott Cubbler / Michael Rodriguez (W),0,0,0,0
Harrison,8,President,,,Cherunda Fox / Roger Kushner (W),0,0,0,0
Harrison,8,President,,,Tom Hoefling / Steve Schulin (W),0,0,0,0
Harrison,8,President,,,Laurence Kotlikoff / Edward Leamer (W),0,1,0,1
Harrison,8,President,,,Jonathan Lee / Jeffrey Erskine (W),0,0,0,0
Harrison,8,President,,,Michael A. Maturen / Juan A. Munoz (W),0,0,0,0
Harrison,8,President,,,Evan McMullin / Nathan Johnson (W),2,9,6,17
Harrison,8,President,,,Monica Moorehead / Lamon Lilly (W),0,0,0,0
Harrison,8,President,,,Robert Morrow / Todd Sanders (W),0,0,0,0
Harrison,8,President,,,Emidio Soltysik / Angela Walker (W),0,0,0,0
Harrison,8,President,,,Dale Steffes / Paul E. Case (W),0,0,0,0
Harrison,8,President,,,Tony Valdivia / Aaron Barriere (W),0,0,0,0
Harrison,8,U.S. House,1,Republican,Louie Gohmert,57,992,239,1288
Harrison,8,U.S. House,1,Democratic,Shirley J. McKellar,19,296,80,395
Harrison,8,U.S. House,1,Libertarian,Phil Gray,2,16,12,30
Harrison,8,U.S. House,1,,Renee Culler (W),0,0,1,1
Harrison,8,Railroad Commissioner,,Republican,Wayne Christian,62,955,228,1245
Harrison,8,Railroad Commissioner,,Democratic,Grady Yarbrough,18,292,79,389
Harrison,8,Railroad Commissioner,,Libertarian,Mark Miller,1,28,17,46
Harrison,8,Railroad Commissioner,,Green,Martina Salinas,0,12,3,15
Harrison,8,"Justice, Supreme Court, Place 3",,,Debra Lehrmann,58,938,237,1233
Harrison,8,"Justice, Supreme Court, Place 3",,,Mike Westergren,20,302,74,396
Harrison,8,"Justice, Supreme Court, Place 3",,,Kathie Glass,1,19,13,33
Harrison,8,"Justice, Supreme Court, Place 3",,,Rodolfo Rivera Munoz,1,7,4,12
Harrison,8,"Justice, Supreme Court, Place 5",,,Paul Green,59,942,227,1228
Harrison,8,"Justice, Supreme Court, Place 5",,,Dori Contreras Garza,20,289,85,394
Harrison,8,"Justice, Supreme Court, Place 5",,,Tom Oxford,0,22,11,33
Harrison,8,"Justice, Supreme Court, Place 5",,,Charles E. Waterbury,1,10,2,13
Harrison,8,"Justice, Supreme Court, Place 9",,,Eva Guzman,61,927,226,1214
Harrison,8,"Justice, Supreme Court, Place 9",,,Savannah Robinson,18,292,86,396
Harrison,8,"Justice, Supreme Court, Place 9",,,Don Fulton,0,26,11,37
Harrison,8,"Justice, Supreme Court, Place 9",,,Jim Chisholm,1,14,2,17
Harrison,8,"Judge, Court of Criminal Appeals, Place 2",,,Mary Lou Keel,61,936,237,1234
Harrison,8,"Judge, Court of Criminal Appeals, Place 2",,,"Lawrence ""Larry"" Meyers",19,296,78,393
Harrison,8,"Judge, Court of Criminal Appeals, Place 2",,,Mark Ash,0,25,11,36
Harrison,8,"Judge, Court of Criminal Appeals, Place 2",,,Adam King Blackwell Reposa,1,8,3,12
Harrison,8,"Judge, Court of Criminal Appeals, Place 5",,,Scott Walker,60,949,229,1238
Harrison,8,"Judge, Court of Criminal Appeals, Place 5",,,Betsy Johnson,18,284,88,390
Harrison,8,"Judge, Court of Criminal Appeals, Place 5",,,"William Bryan Strange, III",0,18,9,27
Harrison,8,"Judge, Court of Criminal Appeals, Place 5",,,Judith Sanders-Castro,1,13,3,17
Harrison,8,"Judge, Court of Criminal Appeals, Place 6",,,Michael E. Keasler,62,932,232,1226
Harrison,8,"Judge, Court of Criminal Appeals, Place 6",,,Robert Burns,19,300,83,402
Harrison,8,"Judge, Court of Criminal Appeals, Place 6",,,Mark W. Bennett,0,27,11,38
Harrison,8,"Member, State Board of Education, District 9",,,Keven M. Ellis,60,931,224,1215
Harrison,8,"Member, State Board of Education, District 9",,,Amanda M. Rudolph,20,302,92,414
Harrison,8,"Member, State Board of Education, District 9",,,Anastasia Wilford,0,30,12,42
Harrison,8,State Senate,1,Republican,Bryan Hughes,66,1077,267,1410
Harrison,8,State Representative,9,Republican,Chris Paddie,66,1104,271,1441
Harrison,8,"Chief Justice, 6th Court of Appeals District",,,Josh Morriss,66,1042,263,1371
Harrison,8,"District Judge, 71st Judicial District",,,Brad Morin,67,1098,271,1436
Harrison,8,Sheriff,,,Tom McCool,64,1104,273,1441
Harrison,8,Tax Assessor-Collector,,,Veronica King,68,1103,274,1445
Harrison,8,"Justice of the Peace, Precinct No. 4 - Unexpired Term",,,Nancy Schnorbus George,66,1085,269,1420
Harrison,8,"Constable, Precinct No. 4",,,Darryl Griffin,67,1050,264,1381
Harrison,9,Straight Party,,,Republican Party,8,254,77,339
Harrison,9,Straight Party,,,Democratic Party,15,130,32,177
Harrison,9,Straight Party,,,Libertarian Party,0,3,1,4
Harrison,9,Straight Party,,,Green Party,0,0,1,1
Harrison,9,President,,Republican,Donald J. Trump / Mike Pence,15,501,123,639
Harrison,9,President,,Democratic,Hillary Clinton / Tim Kaine,18,191,49,258
Harrison,9,President,,Libertarian,Gary Johnson / William Weld,1,13,7,21
Harrison,9,President,,Green,Jill Stein / Ajamu Baraka,0,0,1,1
Harrison,9,President,,,Darrell L. Castle / Scott N. Bradley (W),0,0,0,0
Harrison,9,President,,,Scott Cubbler / Michael Rodriguez (W),0,0,0,0
Harrison,9,President,,,Cherunda Fox / Roger Kushner (W),0,0,0,0
Harrison,9,President,,,Tom Hoefling / Steve Schulin (W),0,0,0,0
Harrison,9,President,,,Laurence Kotlikoff / Edward Leamer (W),0,0,0,0
Harrison,9,President,,,Jonathan Lee / Jeffrey Erskine (W),0,0,0,0
Harrison,9,President,,,Michael A. Maturen / Juan A. Munoz (W),0,0,0,0
Harrison,9,President,,,Evan McMullin / Nathan Johnson (W),0,1,0,1
Harrison,9,President,,,Monica Moorehead / Lamon Lilly (W),0,0,0,0
Harrison,9,President,,,Robert Morrow / Todd Sanders (W),0,0,0,0
Harrison,9,President,,,Emidio Soltysik / Angela Walker (W),0,0,0,0
Harrison,9,President,,,Dale Steffes / Paul E. Case (W),0,0,0,0
Harrison,9,President,,,Tony Valdivia / Aaron Barriere (W),0,0,0,0
Harrison,9,U.S. House,1,Republican,Louie Gohmert,14,512,125,651
Harrison,9,U.S. House,1,Democratic,Shirley J. McKellar,18,182,46,246
Harrison,9,U.S. House,1,Libertarian,Phil Gray,2,8,5,15
Harrison,9,U.S. House,1,,Renee Culler (W),0,0,0,0
Harrison,9,Railroad Commissioner,,Republican,Wayne Christian,14,489,115,618
Harrison,9,Railroad Commissioner,,Democratic,Grady Yarbrough,18,177,49,244
Harrison,9,Railroad Commissioner,,Libertarian,Mark Miller,2,10,6,18
Harrison,9,Railroad Commissioner,,Green,Martina Salinas,0,6,2,8
Harrison,9,"Justice, Supreme Court, Place 3",,,Debra Lehrmann,16,473,115,604
Harrison,9,"Justice, Supreme Court, Place 3",,,Mike Westergren,16,185,47,248
Harrison,9,"Justice, Supreme Court, Place 3",,,Kathie Glass,2,15,8,25
Harrison,9,"Justice, Supreme Court, Place 3",,,Rodolfo Rivera Munoz,0,3,4,7
Harrison,9,"Justice, Supreme Court, Place 5",,,Paul Green,14,473,115,602
Harrison,9,"Justice, Supreme Court, Place 5",,,Dori Contreras Garza,18,190,47,255
Harrison,9,"Justice, Supreme Court, Place 5",,,Tom Oxford,2,6,10,18
Harrison,9,"Justice, Supreme Court, Place 5",,,Charles E. Waterbury,0,3,1,4
Harrison,9,"Justice, Supreme Court, Place 9",,,Eva Guzman,15,465,115,595
Harrison,9,"Justice, Supreme Court, Place 9",,,Savannah Robinson,17,184,44,245
Harrison,9,"Justice, Supreme Court, Place 9",,,Don Fulton,2,9,11,22
Harrison,9,"Justice, Supreme Court, Place 9",,,Jim Chisholm,0,7,2,9
Harrison,9,"Judge, Court of Criminal Appeals, Place 2",,,Mary Lou Keel,14,470,113,597
Harrison,9,"Judge, Court of Criminal Appeals, Place 2",,,"Lawrence ""Larry"" Meyers",17,188,44,249
Harrison,9,"Judge, Court of Criminal Appeals, Place 2",,,Mark Ash,2,14,8,24
Harrison,9,"Judge, Court of Criminal Appeals, Place 2",,,Adam King Blackwell Reposa,0,1,5,6
Harrison,9,"Judge, Court of Criminal Appeals, Place 5",,,Scott Walker,16,479,115,610
Harrison,9,"Judge, Court of Criminal Appeals, Place 5",,,Betsy Johnson,17,184,47,248
Harrison,9,"Judge, Court of Criminal Appeals, Place 5",,,"William Bryan Strange, III",0,9,7,16
Harrison,9,"Judge, Court of Criminal Appeals, Place 5",,,Judith Sanders-Castro,0,5,1,6
Harrison,9,"Judge, Court of Criminal Appeals, Place 6",,,Michael E. Keasler,13,474,113,600
Harrison,9,"Judge, Court of Criminal Appeals, Place 6",,,Robert Burns,18,187,46,251
Harrison,9,"Judge, Court of Criminal Appeals, Place 6",,,Mark W. Bennett,2,13,10,25
Harrison,9,"Member, State Board of Education, District 9",,,Keven M. Ellis,15,466,116,597
Harrison,9,"Member, State Board of Education, District 9",,,Amanda M. Rudolph,17,195,51,263
Harrison,9,"Member, State Board of Education, District 9",,,Anastasia Wilford,2,12,6,20
Harrison,9,State Senate,1,Republican,Bryan Hughes,17,532,133,682
Harrison,9,State Representative,9,Republican,Chris Paddie,17,540,136,693
Harrison,9,"Chief Justice, 6th Court of Appeals District",,,Josh Morriss,17,517,131,665
Harrison,9,"District Judge, 71st Judicial District",,,Brad Morin,18,531,134,683
Harrison,9,Sheriff,,,Tom McCool,16,546,141,703
Harrison,9,Tax Assessor-Collector,,,Veronica King,18,549,138,705
Harrison,9,"Justice of the Peace, Precinct No. 4 - Unexpired Term",,,Nancy Schnorbus George,16,538,141,695
Harrison,9,"Constable, Precinct No. 4",,,Darryl Griffin,16,513,134,663
Harrison,10,Straight Party,,,Republican Party,14,245,45,304
Harrison,10,Straight Party,,,Democratic Party,5,55,15,75
Harrison,10,Straight Party,,,Libertarian Party,0,1,0,1
Harrison,10,Straight Party,,,Green Party,0,0,0,0
Harrison,10,President,,Republican,Donald J. Trump / Mike Pence,22,441,77,540
Harrison,10,President,,Democratic,Hillary Clinton / Tim Kaine,8,111,29,148
Harrison,10,President,,Libertarian,Gary Johnson / William Weld,0,3,1,4
Harrison,10,President,,Green,Jill Stein / Ajamu Baraka,0,0,0,0
Harrison,10,President,,,Darrell L. Castle / Scott N. Bradley (W),0,1,0,1
Harrison,10,President,,,Scott Cubbler / Michael Rodriguez (W),0,0,0,0
Harrison,10,President,,,Cherunda Fox / Roger Kushner (W),0,0,0,0
Harrison,10,President,,,Tom Hoefling / Steve Schulin (W),0,0,0,0
Harrison,10,President,,,Laurence Kotlikoff / Edward Leamer (W),0,0,0,0
Harrison,10,President,,,Jonathan Lee / Jeffrey Erskine (W),0,0,0,0
Harrison,10,President,,,Michael A. Maturen / Juan A. Munoz (W),0,0,0,0
Harrison,10,President,,,Evan McMullin / Nathan Johnson (W),0,1,2,3
Harrison,10,President,,,Monica Moorehead / Lamon Lilly (W),0,0,0,0
Harrison,10,President,,,Robert Morrow / Todd Sanders (W),0,0,0,0
Harrison,10,President,,,Emidio Soltysik / Angela Walker (W),0,0,0,0
Harrison,10,President,,,Dale Steffes / Paul E. Case (W),0,0,0,0
Harrison,10,President,,,Tony Valdivia / Aaron Barriere (W),0,0,0,0
Harrison,10,U.S. House,1,Republican,Louie Gohmert,22,444,77,543
Harrison,10,U.S. House,1,Democratic,Shirley J. McKellar,7,97,27,131
Harrison,10,U.S. House,1,Libertarian,Phil Gray,1,4,1,6
Harrison,10,U.S. House,1,,Renee Culler (W),0,0,1,1
Harrison,10,Railroad Commissioner,,Republican,Wayne Christian,21,426,76,523
Harrison,10,Railroad Commissioner,,Democratic,Grady Yarbrough,8,97,24,129
Harrison,10,Railroad Commissioner,,Libertarian,Mark Miller,0,11,1,12
Harrison,10,Railroad Commissioner,,Green,Martina Salinas,0,4,5,9
Harrison,10,"Justice, Supreme Court, Place 3",,,Debra Lehrmann,21,422,73,516
Harrison,10,"Justice, Supreme Court, Place 3",,,Mike Westergren,8,101,26,135
Harrison,10,"Justice, Supreme Court, Place 3",,,Kathie Glass,0,9,5,14
Harrison,10,"Justice, Supreme Court, Place 3",,,Rodolfo Rivera Munoz,0,3,2,5
Harrison,10,"Justice, Supreme Court, Place 5",,,Paul Green,22,428,77,527
Harrison,10,"Justice, Supreme Court, Place 5",,,Dori Contreras Garza,7,96,27,130
Harrison,10,"Justice, Supreme Court, Place 5",,,Tom Oxford,0,8,2,10
Harrison,10,"Justice, Supreme Court, Place 5",,,Charles E. Waterbury,0,3,0,3
Harrison,10,"Justice, Supreme Court, Place 9",,,Eva Guzman,20,419,73,512
Harrison,10,"Justice, Supreme Court, Place 9",,,Savannah Robinson,9,101,27,137
Harrison,10,"Justice, Supreme Court, Place 9",,,Don Fulton,0,11,4,15
Harrison,10,"Justice, Supreme Court, Place 9",,,Jim Chisholm,0,2,2,4
Harrison,10,"Judge, Court of Criminal Appeals, Place 2",,,Mary Lou Keel,23,425,76,524
Harrison,10,"Judge, Court of Criminal Appeals, Place 2",,,"Lawrence ""Larry"" Meyers",6,100,26,132
Harrison,10,"Judge, Court of Criminal Appeals, Place 2",,,Mark Ash,0,12,3,15
Harrison,10,"Judge, Court of Criminal Appeals, Place 2",,,Adam King Blackwell Reposa,0,2,1,3
Harrison,10,"Judge, Court of Criminal Appeals, Place 5",,,Scott Walker,22,425,75,522
Harrison,10,"Judge, Court of Criminal Appeals, Place 5",,,Betsy Johnson,7,101,27,135
Harrison,10,"Judge, Court of Criminal Appeals, Place 5",,,"William Bryan Strange, III",0,5,2,7
Harrison,10,"Judge, Court of Criminal Appeals, Place 5",,,Judith Sanders-Castro,0,4,2,6
Harrison,10,"Judge, Court of Criminal Appeals, Place 6",,,Michael E. Keasler,21,424,75,520
Harrison,10,"Judge, Court of Criminal Appeals, Place 6",,,Robert Burns,8,102,27,137
Harrison,10,"Judge, Court of Criminal Appeals, Place 6",,,Mark W. Bennett,0,9,4,13
Harrison,10,"Member, State Board of Education, District 9",,,Keven M. Ellis,20,428,73,521
Harrison,10,"Member, State Board of Education, District 9",,,Amanda M. Rudolph,9,99,28,136
Harrison,10,"Member, State Board of Education, District 9",,,Anastasia Wilford,0,9,4,13
Harrison,10,State Senate,1,Republican,Bryan Hughes,23,460,84,567
Harrison,10,State Representative,9,Republican,Chris Paddie,24,460,86,570
Harrison,10,"Chief Justice, 6th Court of Appeals District",,,Josh Morriss,23,454,85,562
Harrison,10,"District Judge, 71st Judicial District",,,Brad Morin,23,469,86,578
Harrison,10,Sheriff,,,Tom McCool,24,471,86,581
Harrison,10,Tax Assessor-Collector,,,Veronica King,25,476,89,590
Harrison,10,"County Commissioner, Precinct No. 1",,,William D. Hatfield,24,459,85,568
Harrison,10,"Constable, Precinct No. 1",,,John C. Hickey Jr,23,443,82,548
Harrison,11,Straight Party,,,Republican Party,8,81,12,101
Harrison,11,Straight Party,,,Democratic Party,5,50,20,75
Harrison,11,Straight Party,,,Libertarian Party,0,1,0,1
Harrison,11,Straight Party,,,Green Party,0,0,0,0
Harrison,11,President,,Republican,Donald J. Trump / Mike Pence,12,142,22,176
Harrison,11,President,,Democratic,Hillary Clinton / Tim Kaine,9,88,30,127
Harrison,11,President,,Libertarian,Gary Johnson / William Weld,0,3,0,3
Harrison,11,President,,Green,Jill Stein / Ajamu Baraka,0,0,0,0
Harrison,11,President,,,Darrell L. Castle / Scott N. Bradley (W),0,0,0,0
Harrison,11,President,,,Scott Cubbler / Michael Rodriguez (W),0,0,0,0
Harrison,11,President,,,Cherunda Fox / Roger Kushner (W),0,0,0,0
Harrison,11,President,,,Tom Hoefling / Steve Schulin (W),0,0,0,0
Harrison,11,President,,,Laurence Kotlikoff / Edward Leamer (W),0,0,0,0
Harrison,11,President,,,Jonathan Lee / Jeffrey Erskine (W),0,0,0,0
Harrison,11,President,,,Michael A. Maturen / Juan A. Munoz (W),0,0,0,0
Harrison,11,President,,,Evan McMullin / Nathan Johnson (W),0,0,0,0
Harrison,11,President,,,Monica Moorehead / Lamon Lilly (W),0,0,0,0
Harrison,11,President,,,Robert Morrow / Todd Sanders (W),0,0,0,0
Harrison,11,President,,,Emidio Soltysik / Angela Walker (W),0,0,0,0
Harrison,11,President,,,Dale Steffes / Paul E. Case (W),0,0,0,0
Harrison,11,President,,,Tony Valdivia / Aaron Barriere (W),0,0,0,0
Harrison,11,U.S. House,1,Republican,Louie Gohmert,12,144,20,176
Harrison,11,U.S. House,1,Democratic,Shirley J. McKellar,7,80,29,116
Harrison,11,U.S. House,1,Libertarian,Phil Gray,0,7,0,7
Harrison,11,U.S. House,1,,Renee Culler (W),0,0,0,0
Harrison,11,Railroad Commissioner,,Republican,Wayne Christian,10,136,19,165
Harrison,11,Railroad Commissioner,,Democratic,Grady Yarbrough,8,80,28,116
Harrison,11,Railroad Commissioner,,Libertarian,Mark Miller,0,10,2,12
Harrison,11,Railroad Commissioner,,Green,Martina Salinas,0,3,0,3
Harrison,11,"Justice, Supreme Court, Place 3",,,Debra Lehrmann,11,135,19,165
Harrison,11,"Justice, Supreme Court, Place 3",,,Mike Westergren,7,78,29,114
Harrison,11,"Justice, Supreme Court, Place 3",,,Kathie Glass,0,9,1,10
Harrison,11,"Justice, Supreme Court, Place 3",,,Rodolfo Rivera Munoz,0,3,0,3
Harrison,11,"Justice, Supreme Court, Place 5",,,Paul Green,11,139,19,169
Harrison,11,"Justice, Supreme Court, Place 5",,,Dori Contreras Garza,7,81,28,116
Harrison,11,"Justice, Supreme Court, Place 5",,,Tom Oxford,0,6,2,8
Harrison,11,"Justice, Supreme Court, Place 5",,,Charles E. Waterbury,0,0,0,0
Harrison,11,"Justice, Supreme Court, Place 9",,,Eva Guzman,11,134,19,164
Harrison,11,"Justice, Supreme Court, Place 9",,,Savannah Robinson,7,81,27,115
Harrison,11,"Justice, Supreme Court, Place 9",,,Don Fulton,0,9,3,12
Harrison,11,"Justice, Supreme Court, Place 9",,,Jim Chisholm,0,1,0,1
Harrison,11,"Judge, Court of Criminal Appeals, Place 2",,,Mary Lou Keel,11,136,19,166
Harrison,11,"Judge, Court of Criminal Appeals, Place 2",,,"Lawrence ""Larry"" Meyers",8,82,26,116
Harrison,11,"Judge, Court of Criminal Appeals, Place 2",,,Mark Ash,0,8,2,10
Harrison,11,"Judge, Court of Criminal Appeals, Place 2",,,Adam King Blackwell Reposa,0,0,0,0
Harrison,11,"Judge, Court of Criminal Appeals, Place 5",,,Scott Walker,11,134,20,165
Harrison,11,"Judge, Court of Criminal Appeals, Place 5",,,Betsy Johnson,8,85,26,119
Harrison,11,"Judge, Court of Criminal Appeals, Place 5",,,"William Bryan Strange, III",0,5,1,6
Harrison,11,"Judge, Court of Criminal Appeals, Place 5",,,Judith Sanders-Castro,0,2,1,3
Harrison,11,"Judge, Court of Criminal Appeals, Place 6",,,Michael E. Keasler,11,132,20,163
Harrison,11,"Judge, Court of Criminal Appeals, Place 6",,,Robert Burns,8,82,26,116
Harrison,11,"Judge, Court of Criminal Appeals, Place 6",,,Mark W. Bennett,0,10,1,11
Harrison,11,"Member, State Board of Education, District 9",,,Keven M. Ellis,12,134,21,167
Harrison,11,"Member, State Board of Education, District 9",,,Amanda M. Rudolph,7,85,26,118
Harrison,11,"Member, State Board of Education, District 9",,,Anastasia Wilford,0,9,0,9
Harrison,11,State Senate,1,Republican,Bryan Hughes,13,158,27,198
Harrison,11,State Representative,9,Republican,Chris Paddie,13,156,29,198
Harrison,11,"Chief Justice, 6th Court of Appeals District",,,Josh Morriss,13,151,29,193
Harrison,11,"District Judge, 71st Judicial District",,,Brad Morin,13,161,28,202
Harrison,11,Sheriff,,,Tom McCool,13,163,32,208
Harrison,11,Tax Assessor-Collector,,,Veronica King,14,163,30,207
Harrison,11,"Constable, Precinct No. 2",,,Brant Moore,9,126,38,173
Harrison,12,Straight Party,,,Republican Party,49,1174,262,1485
Harrison,12,Straight Party,,,Democratic Party,8,131,47,186
Harrison,12,Straight Party,,,Libertarian Party,0,9,8,17
Harrison,12,Straight Party,,,Green Party,0,2,0,2
Harrison,12,President,,Republican,Donald J. Trump / Mike Pence,81,2055,481,2617
Harrison,12,President,,Democratic,Hillary Clinton / Tim Kaine,20,269,83,372
Harrison,12,President,,Libertarian,Gary Johnson / William Weld,3,48,29,80
Harrison,12,President,,Green,Jill Stein / Ajamu Baraka,0,6,2,8
Harrison,12,President,,,Darrell L. Castle / Scott N. Bradley (W),0,0,0,0
Harrison,12,President,,,Scott Cubbler / Michael Rodriguez (W),0,0,0,0
Harrison,12,President,,,Cherunda Fox / Roger Kushner (W),0,0,0,0
Harrison,12,President,,,Tom Hoefling / Steve Schulin (W),0,0,0,0
Harrison,12,President,,,Laurence Kotlikoff / Edward Leamer (W),0,1,0,1
Harrison,12,President,,,Jonathan Lee / Jeffrey Erskine (W),0,0,0,0
Harrison,12,President,,,Michael A. Maturen / Juan A. Munoz (W),0,0,0,0
Harrison,12,President,,,Evan McMullin / Nathan Johnson (W),2,13,5,20
Harrison,12,President,,,Monica Moorehead / Lamon Lilly (W),0,0,0,0
Harrison,12,President,,,Robert Morrow / Todd Sanders (W),0,0,0,0
Harrison,12,President,,,Emidio Soltysik / Angela Walker (W),0,0,0,0
Harrison,12,President,,,Dale Steffes / Paul E. Case (W),0,0,0,0
Harrison,12,President,,,Tony Valdivia / Aaron Barriere (W),0,0,0,0
Harrison,12,U.S. House,1,Republican,Louie Gohmert,85,2075,494,2654
Harrison,12,U.S. House,1,Democratic,Shirley J. McKellar,18,263,78,359
Harrison,12,U.S. House,1,Libertarian,Phil Gray,1,45,22,68
Harrison,12,U.S. House,1,,Renee Culler (W),0,0,0,0
Harrison,12,Railroad Commissioner,,Republican,Wayne Christian,82,1995,469,2546
Harrison,12,Railroad Commissioner,,Democratic,Grady Yarbrough,19,258,69,346
Harrison,12,Railroad Commissioner,,Libertarian,Mark Miller,2,75,36,113
Harrison,12,Railroad Commissioner,,Green,Martina Salinas,0,18,6,24
Harrison,12,"Justice, Supreme Court, Place 3",,,Debra Lehrmann,81,2006,462,2549
Harrison,12,"Justice, Supreme Court, Place 3",,,Mike Westergren,19,271,77,367
Harrison,12,"Justice, Supreme Court, Place 3",,,Kathie Glass,3,55,37,95
Harrison,12,"Justice, Supreme Court, Place 3",,,Rodolfo Rivera Munoz,0,13,7,20
Harrison,12,"Justice, Supreme Court, Place 5",,,Paul Green,82,2021,465,2568
Harrison,12,"Justice, Supreme Court, Place 5",,,Dori Contreras Garza,19,247,74,340
Harrison,12,"Justice, Supreme Court, Place 5",,,Tom Oxford,2,54,35,91
Harrison,12,"Justice, Supreme Court, Place 5",,,Charles E. Waterbury,0,13,4,17
Harrison,12,"Justice, Supreme Court, Place 9",,,Eva Guzman,80,1977,455,2512
Harrison,12,"Justice, Supreme Court, Place 9",,,Savannah Robinson,19,272,81,372
Harrison,12,"Justice, Supreme Court, Place 9",,,Don Fulton,4,64,35,103
Harrison,12,"Justice, Supreme Court, Place 9",,,Jim Chisholm,0,20,11,31
Harrison,12,"Judge, Court of Criminal Appeals, Place 2",,,Mary Lou Keel,81,1997,456,2534
Harrison,12,"Judge, Court of Criminal Appeals, Place 2",,,"Lawrence ""Larry"" Meyers",20,268,78,366
Harrison,12,"Judge, Court of Criminal Appeals, Place 2",,,Mark Ash,2,59,40,101
Harrison,12,"Judge, Court of Criminal Appeals, Place 2",,,Adam King Blackwell Reposa,0,8,5,13
Harrison,12,"Judge, Court of Criminal Appeals, Place 5",,,Scott Walker,84,2015,458,2557
Harrison,12,"Judge, Court of Criminal Appeals, Place 5",,,Betsy Johnson,17,262,81,360
Harrison,12,"Judge, Court of Criminal Appeals, Place 5",,,"William Bryan Strange, III",2,47,34,83
Harrison,12,"Judge, Court of Criminal Appeals, Place 5",,,Judith Sanders-Castro,0,9,6,15
Harrison,12,"Judge, Court of Criminal Appeals, Place 6",,,Michael E. Keasler,82,2007,473,2562
Harrison,12,"Judge, Court of Criminal Appeals, Place 6",,,Robert Burns,19,264,75,358
Harrison,12,"Judge, Court of Criminal Appeals, Place 6",,,Mark W. Bennett,2,59,33,94
Harrison,12,"Member, State Board of Education, District 9",,,Keven M. Ellis,79,1990,460,2529
Harrison,12,"Member, State Board of Education, District 9",,,Amanda M. Rudolph,21,286,85,392
Harrison,12,"Member, State Board of Education, District 9",,,Anastasia Wilford,3,59,33,95
Harrison,12,State Senate,1,Republican,Bryan Hughes,85,2106,521,2712
Harrison,12,State Representative,9,Republican,Chris Paddie,88,2121,522,2731
Harrison,12,"Chief Justice, 6th Court of Appeals District",,,Josh Morriss,88,2109,522,2719
Harrison,12,"District Judge, 71st Judicial District",,,Brad Morin,87,2121,522,2730
Harrison,12,Sheriff,,,Tom McCool,89,2142,525,2756
Harrison,12,Tax Assessor-Collector,,,Veronica King,91,2138,524,2753
Harrison,12,"County Commissioner, Precinct No. 3",,,Phillip G. Mauldin,90,2146,524,2760
Harrison,12,"Constable, Precinct No. 3",,,Jim Weatherall,90,2120,521,2731
Harrison,12,Proposition County JP3,,,For,56,1437,404,1897
Harrison,12,Proposition County JP3,,,Against,32,631,124,787
Harrison,13,Straight Party,,,Republican Party,26,352,120,498
Harrison,13,Straight Party,,,Democratic Party,1,35,9,45
Harrison,13,Straight Party,,,Libertarian Party,0,1,0,1
Harrison,13,Straight Party,,,Green Party,0,0,0,0
Harrison,13,President,,Republican,Donald J. Trump / Mike Pence,36,587,201,824
Harrison,13,President,,Democratic,Hillary Clinton / Tim Kaine,5,69,23,97
Harrison,13,President,,Libertarian,Gary Johnson / William Weld,2,11,5,18
Harrison,13,President,,Green,Jill Stein / Ajamu Baraka,0,1,3,4
Harrison,13,President,,,Darrell L. Castle / Scott N. Bradley (W),0,0,0,0
Harrison,13,President,,,Scott Cubbler / Michael Rodriguez (W),0,0,0,0
Harrison,13,President,,,Cherunda Fox / Roger Kushner (W),0,0,0,0
Harrison,13,President,,,Tom Hoefling / Steve Schulin (W),0,0,0,0
Harrison,13,President,,,Laurence Kotlikoff / Edward Leamer (W),0,0,0,0
Harrison,13,President,,,Jonathan Lee / Jeffrey Erskine (W),0,0,0,0
Harrison,13,President,,,Michael A. Maturen / Juan A. Munoz (W),0,0,0,0
Harrison,13,President,,,Evan McMullin / Nathan Johnson (W),0,1,2,3
Harrison,13,President,,,Monica Moorehead / Lamon Lilly (W),0,0,0,0
Harrison,13,President,,,Robert Morrow / Todd Sanders (W),0,0,0,0
Harrison,13,President,,,Emidio Soltysik / Angela Walker (W),0,0,0,0
Harrison,13,President,,,Dale Steffes / Paul E. Case (W),0,0,0,0
Harrison,13,President,,,Tony Valdivia / Aaron Barriere (W),0,0,0,0
Harrison,13,U.S. House,1,Republican,Louie Gohmert,37,594,211,842
Harrison,13,U.S. House,1,Democratic,Shirley J. McKellar,6,61,21,88
Harrison,13,U.S. House,1,Libertarian,Phil Gray,0,13,2,15
Harrison,13,U.S. House,1,,Renee Culler (W),0,0,0,0
Harrison,13,Railroad Commissioner,,Republican,Wayne Christian,38,580,200,818
Harrison,13,Railroad Commissioner,,Democratic,Grady Yarbrough,3,62,21,86
Harrison,13,Railroad Commissioner,,Libertarian,Mark Miller,0,15,7,22
Harrison,13,Railroad Commissioner,,Green,Martina Salinas,0,4,4,8
Harrison,13,"Justice, Supreme Court, Place 3",,,Debra Lehrmann,37,581,205,823
Harrison,13,"Justice, Supreme Court, Place 3",,,Mike Westergren,4,66,20,90
Harrison,13,"Justice, Supreme Court, Place 3",,,Kathie Glass,0,17,3,20
Harrison,13,"Justice, Supreme Court, Place 3",,,Rodolfo Rivera Munoz,0,1,3,4
Harrison,13,"Justice, Supreme Court, Place 5",,,Paul Green,37,580,205,822
Harrison,13,"Justice, Supreme Court, Place 5",,,Dori Contreras Garza,4,72,19,95
Harrison,13,"Justice, Supreme Court, Place 5",,,Tom Oxford,0,10,5,15
Harrison,13,"Justice, Supreme Court, Place 5",,,Charles E. Waterbury,0,2,3,5
Harrison,13,"Justice, Supreme Court, Place 9",,,Eva Guzman,37,570,207,814
Harrison,13,"Justice, Supreme Court, Place 9",,,Savannah Robinson,4,72,16,92
Harrison,13,"Justice, Supreme Court, Place 9",,,Don Fulton,0,17,9,26
Harrison,13,"Justice, Supreme Court, Place 9",,,Jim Chisholm,0,4,1,5
Harrison,13,"Judge, Court of Criminal Appeals, Place 2",,,Mary Lou Keel,38,578,204,820
Harrison,13,"Judge, Court of Criminal Appeals, Place 2",,,"Lawrence ""Larry"" Meyers",3,68,16,87
Harrison,13,"Judge, Court of Criminal Appeals, Place 2",,,Mark Ash,0,13,11,24
Harrison,13,"Judge, Court of Criminal Appeals, Place 2",,,Adam King Blackwell Reposa,0,2,2,4
Harrison,13,"Judge, Court of Criminal Appeals, Place 5",,,Scott Walker,38,579,202,819
Harrison,13,"Judge, Court of Criminal Appeals, Place 5",,,Betsy Johnson,3,70,24,97
Harrison,13,"Judge, Court of Criminal Appeals, Place 5",,,"William Bryan Strange, III",0,9,4,13
Harrison,13,"Judge, Court of Criminal Appeals, Place 5",,,Judith Sanders-Castro,0,3,3,6
Harrison,13,"Judge, Court of Criminal Appeals, Place 6",,,Michael E. Keasler,38,577,206,821
Harrison,13,"Judge, Court of Criminal Appeals, Place 6",,,Robert Burns,3,69,19,91
Harrison,13,"Judge, Court of Criminal Appeals, Place 6",,,Mark W. Bennett,0,14,6,20
Harrison,13,"Member, State Board of Education, District 9",,,Keven M. Ellis,36,581,199,816
Harrison,13,"Member, State Board of Education, District 9",,,Amanda M. Rudolph,3,67,21,91
Harrison,13,"Member, State Board of Education, District 9",,,Anastasia Wilford,0,13,11,24
Harrison,13,State Senate,1,Republican,Bryan Hughes,38,617,210,865
Harrison,13,State Representative,9,Republican,Chris Paddie,37,609,213,859
Harrison,13,"Chief Justice, 6th Court of Appeals District",,,Josh Morriss,36,613,210,859
Harrison,13,"District Judge, 71st Judicial District",,,Brad Morin,36,620,213,869
Harrison,13,Sheriff,,,Tom McCool,38,613,213,864
Harrison,13,Tax Assessor-Collector,,,Veronica King,39,620,215,874
Harrison,13,"Justice of the Peace, Precinct No. 4 - Unexpired Term",,,Nancy Schnorbus George,36,617,210,863
Harrison,13,"Constable, Precinct No. 4",,,Darryl Griffin,36,611,211,858
Harrison,14,Straight Party,,,Republican Party,14,263,99,376
Harrison,14,Straight Party,,,Democratic Party,8,78,24,110
Harrison,14,Straight Party,,,Libertarian Party,0,0,0,0
Harrison,14,Straight Party,,,Green Party,0,0,0,0
Harrison,14,President,,Republican,Donald J. Trump / Mike Pence,22,499,191,712
Harrison,14,President,,Democratic,Hillary Clinton / Tim Kaine,9,144,36,189
Harrison,14,President,,Libertarian,Gary Johnson / William Weld,0,6,6,12
Harrison,14,President,,Green,Jill Stein / Ajamu Baraka,1,0,1,2
Harrison,14,President,,,Darrell L. Castle / Scott N. Bradley (W),0,0,0,0
Harrison,14,President,,,Scott Cubbler / Michael Rodriguez (W),0,0,0,0
Harrison,14,President,,,Cherunda Fox / Roger Kushner (W),0,0,0,0
Harrison,14,President,,,Tom Hoefling / Steve Schulin (W),0,0,0,0
Harrison,14,President,,,Laurence Kotlikoff / Edward Leamer (W),0,0,0,0
Harrison,14,President,,,Jonathan Lee / Jeffrey Erskine (W),0,0,0,0
Harrison,14,President,,,Michael A. Maturen / Juan A. Munoz (W),0,0,0,0
Harrison,14,President,,,Evan McMullin / Nathan Johnson (W),0,0,1,1
Harrison,14,President,,,Monica Moorehead / Lamon Lilly (W),0,0,0,0
Harrison,14,President,,,Robert Morrow / Todd Sanders (W),0,0,0,0
Harrison,14,President,,,Emidio Soltysik / Angela Walker (W),0,0,0,0
Harrison,14,President,,,Dale Steffes / Paul E. Case (W),0,0,0,0
Harrison,14,President,,,Tony Valdivia / Aaron Barriere (W),0,0,0,0
Harrison,14,U.S. House,1,Republican,Louie Gohmert,22,504,198,724
Harrison,14,U.S. House,1,Democratic,Shirley J. McKellar,10,128,30,168
Harrison,14,U.S. House,1,Libertarian,Phil Gray,1,9,6,16
Harrison,14,U.S. House,1,,Renee Culler (W),0,0,0,0
Harrison,14,Railroad Commissioner,,Republican,Wayne Christian,24,475,178,677
Harrison,14,Railroad Commissioner,,Democratic,Grady Yarbrough,9,140,40,189
Harrison,14,Railroad Commissioner,,Libertarian,Mark Miller,0,14,7,21
Harrison,14,Railroad Commissioner,,Green,Martina Salinas,0,4,5,9
Harrison,14,"Justice, Supreme Court, Place 3",,,Debra Lehrmann,23,486,184,693
Harrison,14,"Justice, Supreme Court, Place 3",,,Mike Westergren,10,135,35,180
Harrison,14,"Justice, Supreme Court, Place 3",,,Kathie Glass,0,10,8,18
Harrison,14,"Justice, Supreme Court, Place 3",,,Rodolfo Rivera Munoz,0,1,4,5
Harrison,14,"Justice, Supreme Court, Place 5",,,Paul Green,24,490,187,701
Harrison,14,"Justice, Supreme Court, Place 5",,,Dori Contreras Garza,9,131,36,176
Harrison,14,"Justice, Supreme Court, Place 5",,,Tom Oxford,0,9,5,14
Harrison,14,"Justice, Supreme Court, Place 5",,,Charles E. Waterbury,0,2,3,5
Harrison,14,"Justice, Supreme Court, Place 9",,,Eva Guzman,23,475,178,676
Harrison,14,"Justice, Supreme Court, Place 9",,,Savannah Robinson,10,135,41,186
Harrison,14,"Justice, Supreme Court, Place 9",,,Don Fulton,0,13,5,18
Harrison,14,"Justice, Supreme Court, Place 9",,,Jim Chisholm,0,6,5,11
Harrison,14,"Judge, Court of Criminal Appeals, Place 2",,,Mary Lou Keel,22,481,181,684
Harrison,14,"Judge, Court of Criminal Appeals, Place 2",,,"Lawrence ""Larry"" Meyers",11,133,37,181
Harrison,14,"Judge, Court of Criminal Appeals, Place 2",,,Mark Ash,0,6,9,15
Harrison,14,"Judge, Court of Criminal Appeals, Place 2",,,Adam King Blackwell Reposa,0,2,2,4
Harrison,14,"Judge, Court of Criminal Appeals, Place 5",,,Scott Walker,24,483,183,690
Harrison,14,"Judge, Court of Criminal Appeals, Place 5",,,Betsy Johnson,9,133,41,183
Harrison,14,"Judge, Court of Criminal Appeals, Place 5",,,"William Bryan Strange, III",0,9,3,12
Harrison,14,"Judge, Court of Criminal Appeals, Place 5",,,Judith Sanders-Castro,0,1,3,4
Harrison,14,"Judge, Court of Criminal Appeals, Place 6",,,Michael E. Keasler,24,473,182,679
Harrison,14,"Judge, Court of Criminal Appeals, Place 6",,,Robert Burns,9,142,39,190
Harrison,14,"Judge, Court of Criminal Appeals, Place 6",,,Mark W. Bennett,0,9,7,16
Harrison,14,"Member, State Board of Education, District 9",,,Keven M. Ellis,22,472,177,671
Harrison,14,"Member, State Board of Education, District 9",,,Amanda M. Rudolph,11,141,45,197
Harrison,14,"Member, State Board of Education, District 9",,,Anastasia Wilford,0,13,6,19
Harrison,14,State Senate,1,Republican,Bryan Hughes,26,514,204,744
Harrison,14,State Representative,9,Republican,Chris Paddie,26,515,204,745
Harrison,14,"Chief Justice, 6th Court of Appeals District",,,Josh Morriss,26,506,198,730
Harrison,14,"District Judge, 71st Judicial District",,,Brad Morin,26,530,201,757
Harrison,14,Sheriff,,,Tom McCool,26,525,199,750
Harrison,14,Tax Assessor-Collector,,,Veronica King,26,532,204,762
Harrison,14,"Justice of the Peace, Precinct No. 4 - Unexpired Term",,,Nancy Schnorbus George,25,536,203,764
Harrison,14,"Constable, Precinct No. 4",,,Darryl Griffin,25,509,193,727
Harrison,14,"Trustee, Place 3 Karnack",,,Lacy D. Warren,0,20,8,28
Harrison,14,"Trustee, Place 3 Karnack",,,Jimmy P. Theodos,3,17,16,36
Harrison,15,Straight Party,,,Republican Party,15,235,96,346
Harrison,15,Straight Party,,,Democratic Party,2,21,8,31
Harrison,15,Straight Party,,,Libertarian Party,0,1,0,1
Harrison,15,Straight Party,,,Green Party,0,0,1,1
Harrison,15,President,,Republican,Donald J. Trump / Mike Pence,24,447,163,634
Harrison,15,President,,Democratic,Hillary Clinton / Tim Kaine,5,35,19,59
Harrison,15,President,,Libertarian,Gary Johnson / William Weld,0,12,5,17
Harrison,15,President,,Green,Jill Stein / Ajamu Baraka,0,0,0,0
Harrison,15,President,,,Darrell L. Castle / Scott N. Bradley (W),0,0,0,0
Harrison,15,President,,,Scott Cubbler / Michael Rodriguez (W),0,0,0,0
Harrison,15,President,,,Cherunda Fox / Roger Kushner (W),0,0,0,0
Harrison,15,President,,,Tom Hoefling / Steve Schulin (W),0,0,0,0
Harrison,15,President,,,Laurence Kotlikoff / Edward Leamer (W),0,0,0,0
Harrison,15,President,,,Jonathan Lee / Jeffrey Erskine (W),0,0,0,0
Harrison,15,President,,,Michael A. Maturen / Juan A. Munoz (W),0,0,0,0
Harrison,15,President,,,Evan McMullin / Nathan Johnson (W),0,1,0,1
Harrison,15,President,,,Monica Moorehead / Lamon Lilly (W),0,0,0,0
Harrison,15,President,,,Robert Morrow / Todd Sanders (W),0,0,0,0
Harrison,15,President,,,Emidio Soltysik / Angela Walker (W),0,0,0,0
Harrison,15,President,,,Dale Steffes / Paul E. Case (W),0,0,0,0
Harrison,15,President,,,Tony Valdivia / Aaron Barriere (W),0,0,0,0
Harrison,15,U.S. House,1,Republican,Louie Gohmert,25,441,165,631
Harrison,15,U.S. House,1,Democratic,Shirley J. McKellar,4,41,15,60
Harrison,15,U.S. House,1,Libertarian,Phil Gray,0,12,6,18
Harrison,15,U.S. House,1,,Renee Culler (W),0,0,0,0
Harrison,15,Railroad Commissioner,,Republican,Wayne Christian,25,422,158,605
Harrison,15,Railroad Commissioner,,Democratic,Grady Yarbrough,4,42,16,62
Harrison,15,Railroad Commissioner,,Libertarian,Mark Miller,0,15,8,23
Harrison,15,Railroad Commissioner,,Green,Martina Salinas,0,2,1,3
Harrison,15,"Justice, Supreme Court, Place 3",,,Debra Lehrmann,25,410,158,593
Harrison,15,"Justice, Supreme Court, Place 3",,,Mike Westergren,4,46,15,65
Harrison,15,"Justice, Supreme Court, Place 3",,,Kathie Glass,0,20,6,26
Harrison,15,"Justice, Supreme Court, Place 3",,,Rodolfo Rivera Munoz,0,4,2,6
Harrison,15,"Justice, Supreme Court, Place 5",,,Paul Green,25,427,158,610
Harrison,15,"Justice, Supreme Court, Place 5",,,Dori Contreras Garza,4,37,13,54
Harrison,15,"Justice, Supreme Court, Place 5",,,Tom Oxford,0,13,5,18
Harrison,15,"Justice, Supreme Court, Place 5",,,Charles E. Waterbury,0,3,3,6
Harrison,15,"Justice, Supreme Court, Place 9",,,Eva Guzman,25,408,148,581
Harrison,15,"Justice, Supreme Court, Place 9",,,Savannah Robinson,4,44,20,68
Harrison,15,"Justice, Supreme Court, Place 9",,,Don Fulton,0,17,6,23
Harrison,15,"Justice, Supreme Court, Place 9",,,Jim Chisholm,0,6,7,13
Harrison,15,"Judge, Court of Criminal Appeals, Place 2",,,Mary Lou Keel,24,411,157,592
Harrison,15,"Judge, Court of Criminal Appeals, Place 2",,,"Lawrence ""Larry"" Meyers",4,44,18,66
Harrison,15,"Judge, Court of Criminal Appeals, Place 2",,,Mark Ash,0,20,6,26
Harrison,15,"Judge, Court of Criminal Appeals, Place 2",,,Adam King Blackwell Reposa,0,1,0,1
Harrison,15,"Judge, Court of Criminal Appeals, Place 5",,,Scott Walker,25,427,154,606
Harrison,15,"Judge, Court of Criminal Appeals, Place 5",,,Betsy Johnson,4,39,20,63
Harrison,15,"Judge, Court of Criminal Appeals, Place 5",,,"William Bryan Strange, III",0,9,4,13
Harrison,15,"Judge, Court of Criminal Appeals, Place 5",,,Judith Sanders-Castro,0,5,1,6
Harrison,15,"Judge, Court of Criminal Appeals, Place 6",,,Michael E. Keasler,25,414,151,590
Harrison,15,"Judge, Court of Criminal Appeals, Place 6",,,Robert Burns,4,42,20,66
Harrison,15,"Judge, Court of Criminal Appeals, Place 6",,,Mark W. Bennett,0,19,9,28
Harrison,15,"Member, State Board of Education, District 9",,,Keven M. Ellis,25,417,151,593
Harrison,15,"Member, State Board of Education, District 9",,,Amanda M. Rudolph,4,47,22,73
Harrison,15,"Member, State Board of Education, District 9",,,Anastasia Wilford,0,14,8,22
Harrison,15,State Senate,1,Republican,Bryan Hughes,24,442,166,632
Harrison,15,State Representative,9,Republican,Chris Paddie,25,437,167,629
Harrison,15,"Chief Justice, 6th Court of Appeals District",,,Josh Morriss,23,437,164,624
Harrison,15,"District Judge, 71st Judicial District",,,Brad Morin,24,440,165,629
Harrison,15,Sheriff,,,Tom McCool,23,442,167,632
Harrison,15,Tax Assessor-Collector,,,Veronica King,24,447,166,637
Harrison,15,"Justice of the Peace, Precinct No. 4 - Unexpired Term",,,Nancy Schnorbus George,25,447,166,638
Harrison,15,"Constable, Precinct No. 4",,,Darryl Griffin,24,433,163,620
Harrison,15,"Trustee, Place 1 Harleton",,,Charlie Mangham,4,117,39,160
Harrison,15,"Trustee, Place 1 Harleton",,,Kevin Wright,11,213,94,318
Harrison,15,"Trustee, Place 2 Harleton",,,Brad Nixon,8,172,64,244
Harrison,15,"Trustee, Place 2 Harleton",,,Randy Pilkington,5,157,64,226
Harrison,15,"Trustee, Place 3 Harleton",,,Mike Bullock,7,282,114,403
Harrison,15,"Trustee, Place 5 Harleton",,,Brian Degner,7,274,107,388
Harrison,15,"Trustee, Place 6 Harleton",,,Pat McGill,6,207,89,302
Harrison,15,"Trustee, Place 6 Harleton",,,Paul D. Wilson,8,126,43,177
Harrison,16,Straight Party,,,Republican Party,5,115,55,175
Harrison,16,Straight Party,,,Democratic Party,5,15,18,38
Harrison,16,Straight Party,,,Libertarian Party,0,2,0,2
Harrison,16,Straight Party,,,Green Party,0,0,0,0
Harrison,16,President,,Republican,Donald J. Trump / Mike Pence,10,187,122,319
Harrison,16,President,,Democratic,Hillary Clinton / Tim Kaine,5,23,27,55
Harrison,16,President,,Libertarian,Gary Johnson / William Weld,0,4,3,7
Harrison,16,President,,Green,Jill Stein / Ajamu Baraka,0,0,0,0
Harrison,16,President,,,Darrell L. Castle / Scott N. Bradley (W),0,1,0,1
Harrison,16,President,,,Scott Cubbler / Michael Rodriguez (W),0,0,0,0
Harrison,16,President,,,Cherunda Fox / Roger Kushner (W),0,0,0,0
Harrison,16,President,,,Tom Hoefling / Steve Schulin (W),0,0,0,0
Harrison,16,President,,,Laurence Kotlikoff / Edward Leamer (W),0,0,0,0
Harrison,16,President,,,Jonathan Lee / Jeffrey Erskine (W),0,0,0,0
Harrison,16,President,,,Michael A. Maturen / Juan A. Munoz (W),0,0,0,0
Harrison,16,President,,,Evan McMullin / Nathan Johnson (W),0,1,0,1
Harrison,16,President,,,Monica Moorehead / Lamon Lilly (W),0,0,0,0
Harrison,16,President,,,Robert Morrow / Todd Sanders (W),0,0,0,0
Harrison,16,President,,,Emidio Soltysik / Angela Walker (W),0,0,0,0
Harrison,16,President,,,Dale Steffes / Paul E. Case (W),0,0,0,0
Harrison,16,President,,,Tony Valdivia / Aaron Barriere (W),0,0,0,0
Harrison,16,U.S. House,1,Republican,Louie Gohmert,11,190,118,319
Harrison,16,U.S. House,1,Democratic,Shirley J. McKellar,6,23,28,57
Harrison,16,U.S. House,1,Libertarian,Phil Gray,0,3,3,6
Harrison,16,U.S. House,1,,Renee Culler (W),0,0,0,0
Harrison,16,Railroad Commissioner,,Republican,Wayne Christian,9,180,100,289
Harrison,16,Railroad Commissioner,,Democratic,Grady Yarbrough,8,25,35,68
Harrison,16,Railroad Commissioner,,Libertarian,Mark Miller,0,7,5,12
Harrison,16,Railroad Commissioner,,Green,Martina Salinas,0,3,1,4
Harrison,16,"Justice, Supreme Court, Place 3",,,Debra Lehrmann,9,180,108,297
Harrison,16,"Justice, Supreme Court, Place 3",,,Mike Westergren,8,24,32,64
Harrison,16,"Justice, Supreme Court, Place 3",,,Kathie Glass,0,9,5,14
Harrison,16,"Justice, Supreme Court, Place 3",,,Rodolfo Rivera Munoz,0,2,0,2
Harrison,16,"Justice, Supreme Court, Place 5",,,Paul Green,9,185,113,307
Harrison,16,"Justice, Supreme Court, Place 5",,,Dori Contreras Garza,8,22,28,58
Harrison,16,"Justice, Supreme Court, Place 5",,,Tom Oxford,0,7,2,9
Harrison,16,"Justice, Supreme Court, Place 5",,,Charles E. Waterbury,0,1,0,1
Harrison,16,"Justice, Supreme Court, Place 9",,,Eva Guzman,9,178,105,292
Harrison,16,"Justice, Supreme Court, Place 9",,,Savannah Robinson,8,26,31,65
Harrison,16,"Justice, Supreme Court, Place 9",,,Don Fulton,0,9,5,14
Harrison,16,"Justice, Supreme Court, Place 9",,,Jim Chisholm,0,2,1,3
Harrison,16,"Judge, Court of Criminal Appeals, Place 2",,,Mary Lou Keel,10,183,108,301
Harrison,16,"Judge, Court of Criminal Appeals, Place 2",,,"Lawrence ""Larry"" Meyers",7,24,31,62
Harrison,16,"Judge, Court of Criminal Appeals, Place 2",,,Mark Ash,0,6,3,9
Harrison,16,"Judge, Court of Criminal Appeals, Place 2",,,Adam King Blackwell Reposa,0,2,0,2
Harrison,16,"Judge, Court of Criminal Appeals, Place 5",,,Scott Walker,8,186,109,303
Harrison,16,"Judge, Court of Criminal Appeals, Place 5",,,Betsy Johnson,8,26,29,63
Harrison,16,"Judge, Court of Criminal Appeals, Place 5",,,"William Bryan Strange, III",0,3,4,7
Harrison,16,"Judge, Court of Criminal Appeals, Place 5",,,Judith Sanders-Castro,0,0,0,0
Harrison,16,"Judge, Court of Criminal Appeals, Place 6",,,Michael E. Keasler,9,183,105,297
Harrison,16,"Judge, Court of Criminal Appeals, Place 6",,,Robert Burns,8,23,30,61
Harrison,16,"Judge, Court of Criminal Appeals, Place 6",,,Mark W. Bennett,0,9,6,15
Harrison,16,"Member, State Board of Education, District 9",,,Keven M. Ellis,10,186,110,306
Harrison,16,"Member, State Board of Education, District 9",,,Amanda M. Rudolph,7,24,29,60
Harrison,16,"Member, State Board of Education, District 9",,,Anastasia Wilford,0,5,3,8
Harrison,16,State Senate,1,Republican,Bryan Hughes,10,190,114,314
Harrison,16,State Representative,9,Republican,Chris Paddie,11,189,118,318
Harrison,16,"Chief Justice, 6th Court of Appeals District",,,Josh Morriss,10,188,115,313
Harrison,16,"District Judge, 71st Judicial District",,,Brad Morin,11,187,114,312
Harrison,16,Sheriff,,,Tom McCool,11,185,115,311
Harrison,16,Tax Assessor-Collector,,,Veronica King,12,188,123,323
Harrison,16,"Justice of the Peace, Precinct No. 4 - Unexpired Term",,,Nancy Schnorbus George,11,191,113,315
Harrison,16,"Constable, Precinct No. 4",,,Darryl Griffin,11,187,113,311
Harrison,16,"Trustee, Place 1 Harleton",,,Charlie Mangham,3,45,38,86
Harrison,16,"Trustee, Place 1 Harleton",,,Kevin Wright,5,113,67,185
Harrison,16,"Trustee, Place 2 Harleton",,,Brad Nixon,6,81,52,139
Harrison,16,"Trustee, Place 2 Harleton",,,Randy Pilkington,2,75,52,129
Harrison,16,"Trustee, Place 3 Harleton",,,Mike Bullock,8,139,82,229
Harrison,16,"Trustee, Place 5 Harleton",,,Brian Degner,8,133,81,222
Harrison,16,"Trustee, Place 6 Harleton",,,Pat McGill,6,95,51,152
Harrison,16,"Trustee, Place 6 Harleton",,,Paul D. Wilson,2,54,50,106
Harrison,17,Straight Party,,,Republican Party,19,174,57,250
Harrison,17,Straight Party,,,Democratic Party,33,198,76,307
Harrison,17,Straight Party,,,Libertarian Party,0,2,0,2
Harrison,17,Straight Party,,,Green Party,0,1,1,2
Harrison,17,President,,Republican,Donald J. Trump / Mike Pence,20,357,115,492
Harrison,17,President,,Democratic,Hillary Clinton / Tim Kaine,39,291,122,452
Harrison,17,President,,Libertarian,Gary Johnson / William Weld,0,3,1,4
Harrison,17,President,,Green,Jill Stein / Ajamu Baraka,0,0,1,1
Harrison,17,President,,,Darrell L. Castle / Scott N. Bradley (W),0,0,0,0
Harrison,17,President,,,Scott Cubbler / Michael Rodriguez (W),0,0,0,0
Harrison,17,President,,,Cherunda Fox / Roger Kushner (W),0,0,0,0
Harrison,17,President,,,Tom Hoefling / Steve Schulin (W),0,0,0,0
Harrison,17,President,,,Laurence Kotlikoff / Edward Leamer (W),0,0,0,0
Harrison,17,President,,,Jonathan Lee / Jeffrey Erskine (W),0,0,0,0
Harrison,17,President,,,Michael A. Maturen / Juan A. Munoz (W),0,0,0,0
Harrison,17,President,,,Evan McMullin / Nathan Johnson (W),0,1,2,3
Harrison,17,President,,,Monica Moorehead / Lamon Lilly (W),0,0,0,0
Harrison,17,President,,,Robert Morrow / Todd Sanders (W),0,0,0,0
Harrison,17,President,,,Emidio Soltysik / Angela Walker (W),0,0,0,0
Harrison,17,President,,,Dale Steffes / Paul E. Case (W),0,0,0,0
Harrison,17,President,,,Tony Valdivia / Aaron Barriere (W),0,0,0,0
Harrison,17,U.S. House,1,Republican,Louie Gohmert,19,356,116,491
Harrison,17,U.S. House,1,Democratic,Shirley J. McKellar,39,282,110,431
Harrison,17,U.S. House,1,Libertarian,Phil Gray,0,2,2,4
Harrison,17,U.S. House,1,,Renee Culler (W),0,0,0,0
Harrison,17,Railroad Commissioner,,Republican,Wayne Christian,19,334,105,458
Harrison,17,Railroad Commissioner,,Democratic,Grady Yarbrough,39,285,116,440
Harrison,17,Railroad Commissioner,,Libertarian,Mark Miller,0,9,2,11
Harrison,17,Railroad Commissioner,,Green,Martina Salinas,0,5,7,12
Harrison,17,"Justice, Supreme Court, Place 3",,,Debra Lehrmann,19,341,106,466
Harrison,17,"Justice, Supreme Court, Place 3",,,Mike Westergren,39,276,111,426
Harrison,17,"Justice, Supreme Court, Place 3",,,Kathie Glass,0,10,6,16
Harrison,17,"Justice, Supreme Court, Place 3",,,Rodolfo Rivera Munoz,0,3,6,9
Harrison,17,"Justice, Supreme Court, Place 5",,,Paul Green,19,329,110,458
Harrison,17,"Justice, Supreme Court, Place 5",,,Dori Contreras Garza,39,288,115,442
Harrison,17,"Justice, Supreme Court, Place 5",,,Tom Oxford,0,10,3,13
Harrison,17,"Justice, Supreme Court, Place 5",,,Charles E. Waterbury,0,4,1,5
Harrison,17,"Justice, Supreme Court, Place 9",,,Eva Guzman,19,328,107,454
Harrison,17,"Justice, Supreme Court, Place 9",,,Savannah Robinson,39,283,114,436
Harrison,17,"Justice, Supreme Court, Place 9",,,Don Fulton,0,13,4,17
Harrison,17,"Justice, Supreme Court, Place 9",,,Jim Chisholm,0,5,4,9
Harrison,17,"Judge, Court of Criminal Appeals, Place 2",,,Mary Lou Keel,19,331,109,459
Harrison,17,"Judge, Court of Criminal Appeals, Place 2",,,"Lawrence ""Larry"" Meyers",38,284,112,434
Harrison,17,"Judge, Court of Criminal Appeals, Place 2",,,Mark Ash,0,14,2,16
Harrison,17,"Judge, Court of Criminal Appeals, Place 2",,,Adam King Blackwell Reposa,0,3,3,6
Harrison,17,"Judge, Court of Criminal Appeals, Place 5",,,Scott Walker,19,334,107,460
Harrison,17,"Judge, Court of Criminal Appeals, Place 5",,,Betsy Johnson,39,285,113,437
Harrison,17,"Judge, Court of Criminal Appeals, Place 5",,,"William Bryan Strange, III",0,6,3,9
Harrison,17,"Judge, Court of Criminal Appeals, Place 5",,,Judith Sanders-Castro,0,3,4,7
Harrison,17,"Judge, Court of Criminal Appeals, Place 6",,,Michael E. Keasler,19,333,105,457
Harrison,17,"Judge, Court of Criminal Appeals, Place 6",,,Robert Burns,39,280,113,432
Harrison,17,"Judge, Court of Criminal Appeals, Place 6",,,Mark W. Bennett,0,14,7,21
Harrison,17,"Member, State Board of Education, District 9",,,Keven M. Ellis,19,334,103,456
Harrison,17,"Member, State Board of Education, District 9",,,Amanda M. Rudolph,39,288,119,446
Harrison,17,"Member, State Board of Education, District 9",,,Anastasia Wilford,0,5,4,9
Harrison,17,State Senate,1,Republican,Bryan Hughes,21,394,127,542
Harrison,17,State Representative,9,Republican,Chris Paddie,22,395,141,558
Harrison,17,"Chief Justice, 6th Court of Appeals District",,,Josh Morriss,20,390,136,546
Harrison,17,"District Judge, 71st Judicial District",,,Brad Morin,22,407,139,568
Harrison,17,Sheriff,,,Tom McCool,26,415,148,589
Harrison,17,Tax Assessor-Collector,,,Veronica King,26,426,151,603
Harrison,17,"Constable, Precinct No. 2",,,Brant Moore,41,395,164,600
Harrison,17,"Trustee, Place 3 Karnack",,,Lacy D. Warren,4,65,30,99
Harrison,17,"Trustee, Place 3 Karnack",,,Jimmy P. Theodos,11,64,39,114
Harrison,18,Straight Party,,,Republican Party,14,173,34,221
Harrison,18,Straight Party,,,Democratic Party,1,30,9,40
Harrison,18,Straight Party,,,Libertarian Party,0,0,0,0
Harrison,18,Straight Party,,,Green Party,0,1,0,1
Harrison,18,President,,Republican,Donald J. Trump / Mike Pence,18,337,65,420
Harrison,18,President,,Democratic,Hillary Clinton / Tim Kaine,4,59,16,79
Harrison,18,President,,Libertarian,Gary Johnson / William Weld,0,5,5,10
Harrison,18,President,,Green,Jill Stein / Ajamu Baraka,0,2,0,2
Harrison,18,President,,,Darrell L. Castle / Scott N. Bradley (W),0,0,0,0
Harrison,18,President,,,Scott Cubbler / Michael Rodriguez (W),0,0,0,0
Harrison,18,President,,,Cherunda Fox / Roger Kushner (W),0,0,0,0
Harrison,18,President,,,Tom Hoefling / Steve Schulin (W),0,0,0,0
Harrison,18,President,,,Laurence Kotlikoff / Edward Leamer (W),0,0,0,0
Harrison,18,President,,,Jonathan Lee / Jeffrey Erskine (W),0,0,0,0
Harrison,18,President,,,Michael A. Maturen / Juan A. Munoz (W),0,0,0,0
Harrison,18,President,,,Evan McMullin / Nathan Johnson (W),0,1,1,2
Harrison,18,President,,,Monica Moorehead / Lamon Lilly (W),0,0,0,0
Harrison,18,President,,,Robert Morrow / Todd Sanders (W),0,0,0,0
Harrison,18,President,,,Emidio Soltysik / Angela Walker (W),0,0,0,0
Harrison,18,President,,,Dale Steffes / Paul E. Case (W),0,0,0,0
Harrison,18,President,,,Tony Valdivia / Aaron Barriere (W),0,0,0,0
Harrison,18,U.S. House,1,Republican,Louie Gohmert,19,338,68,425
Harrison,18,U.S. House,1,Democratic,Shirley J. McKellar,2,53,18,73
Harrison,18,U.S. House,1,Libertarian,Phil Gray,1,9,1,11
Harrison,18,U.S. House,1,,Renee Culler (W),0,0,0,0
Harrison,18,Railroad Commissioner,,Republican,Wayne Christian,19,324,63,406
Harrison,18,Railroad Commissioner,,Democratic,Grady Yarbrough,2,49,18,69
Harrison,18,Railroad Commissioner,,Libertarian,Mark Miller,0,16,3,19
Harrison,18,Railroad Commissioner,,Green,Martina Salinas,0,1,3,4
Harrison,18,"Justice, Supreme Court, Place 3",,,Debra Lehrmann,20,323,60,403
Harrison,18,"Justice, Supreme Court, Place 3",,,Mike Westergren,1,58,18,77
Harrison,18,"Justice, Supreme Court, Place 3",,,Kathie Glass,0,7,2,9
Harrison,18,"Justice, Supreme Court, Place 3",,,Rodolfo Rivera Munoz,0,2,5,7
Harrison,18,"Justice, Supreme Court, Place 5",,,Paul Green,19,327,66,412
Harrison,18,"Justice, Supreme Court, Place 5",,,Dori Contreras Garza,1,52,15,68
Harrison,18,"Justice, Supreme Court, Place 5",,,Tom Oxford,0,9,2,11
Harrison,18,"Justice, Supreme Court, Place 5",,,Charles E. Waterbury,0,1,2,3
Harrison,18,"Justice, Supreme Court, Place 9",,,Eva Guzman,20,329,63,412
Harrison,18,"Justice, Supreme Court, Place 9",,,Savannah Robinson,1,49,17,67
Harrison,18,"Justice, Supreme Court, Place 9",,,Don Fulton,0,9,2,11
Harrison,18,"Justice, Supreme Court, Place 9",,,Jim Chisholm,0,2,2,4
Harrison,18,"Judge, Court of Criminal Appeals, Place 2",,,Mary Lou Keel,19,328,65,412
Harrison,18,"Judge, Court of Criminal Appeals, Place 2",,,"Lawrence ""Larry"" Meyers",1,50,17,68
Harrison,18,"Judge, Court of Criminal Appeals, Place 2",,,Mark Ash,0,10,1,11
Harrison,18,"Judge, Court of Criminal Appeals, Place 2",,,Adam King Blackwell Reposa,0,0,2,2
Harrison,18,"Judge, Court of Criminal Appeals, Place 5",,,Scott Walker,19,328,67,414
Harrison,18,"Judge, Court of Criminal Appeals, Place 5",,,Betsy Johnson,1,55,15,71
Harrison,18,"Judge, Court of Criminal Appeals, Place 5",,,"William Bryan Strange, III",0,4,1,5
Harrison,18,"Judge, Court of Criminal Appeals, Place 5",,,Judith Sanders-Castro,0,1,2,3
Harrison,18,"Judge, Court of Criminal Appeals, Place 6",,,Michael E. Keasler,19,325,66,410
Harrison,18,"Judge, Court of Criminal Appeals, Place 6",,,Robert Burns,1,54,15,70
Harrison,18,"Judge, Court of Criminal Appeals, Place 6",,,Mark W. Bennett,0,8,4,12
Harrison,18,"Member, State Board of Education, District 9",,,Keven M. Ellis,20,323,62,405
Harrison,18,"Member, State Board of Education, District 9",,,Amanda M. Rudolph,1,59,22,82
Harrison,18,"Member, State Board of Education, District 9",,,Anastasia Wilford,0,9,1,10
Harrison,18,State Senate,1,Republican,Bryan Hughes,20,342,72,434
Harrison,18,State Representative,9,Republican,Chris Paddie,20,345,75,440
Harrison,18,"Chief Justice, 6th Court of Appeals District",,,Josh Morriss,19,341,74,434
Harrison,18,"District Judge, 71st Judicial District",,,Brad Morin,20,351,76,447
Harrison,18,Sheriff,,,Tom McCool,20,350,80,450
Harrison,18,Tax Assessor-Collector,,,Veronica King,20,353,76,449
Harrison,18,"County Commissioner, Precinct No. 1",,,William D. Hatfield,20,347,73,440
Harrison,18,"Constable, Precinct No. 1",,,John C. Hickey Jr,20,329,75,424
Harrison,18,"Trustee, Place 3 Karnack",,,Lacy D. Warren,0,1,0,1
Harrison,18,"Trustee, Place 3 Karnack",,,Jimmy P. Theodos,0,0,0,0
Harrison,19,Straight Party,,,Republican Party,32,694,209,935
Harrison,19,Straight Party,,,Democratic Party,10,122,64,196
Harrison,19,Straight Party,,,Libertarian Party,0,4,3,7
Harrison,19,Straight Party,,,Green Party,0,0,2,2
Harrison,19,President,,Republican,Donald J. Trump / Mike Pence,48,1200,375,1623
Harrison,19,President,,Democratic,Hillary Clinton / Tim Kaine,23,215,87,325
Harrison,19,President,,Libertarian,Gary Johnson / William Weld,1,36,9,46
Harrison,19,President,,Green,Jill Stein / Ajamu Baraka,0,1,6,7
Harrison,19,President,,,Darrell L. Castle / Scott N. Bradley (W),0,2,1,3
Harrison,19,President,,,Scott Cubbler / Michael Rodriguez (W),0,0,0,0
Harrison,19,President,,,Cherunda Fox / Roger Kushner (W),0,0,0,0
Harrison,19,President,,,Tom Hoefling / Steve Schulin (W),0,0,0,0
Harrison,19,President,,,Laurence Kotlikoff / Edward Leamer (W),0,0,0,0
Harrison,19,President,,,Jonathan Lee / Jeffrey Erskine (W),0,0,0,0
Harrison,19,President,,,Michael A. Maturen / Juan A. Munoz (W),0,0,0,0
Harrison,19,President,,,Evan McMullin / Nathan Johnson (W),0,6,0,6
Harrison,19,President,,,Monica Moorehead / Lamon Lilly (W),0,0,0,0
Harrison,19,President,,,Robert Morrow / Todd Sanders (W),1,0,0,1
Harrison,19,President,,,Emidio Soltysik / Angela Walker (W),0,0,0,0
Harrison,19,President,,,Dale Steffes / Paul E. Case (W),0,1,0,1
Harrison,19,President,,,Tony Valdivia / Aaron Barriere (W),0,0,0,0
Harrison,19,U.S. House,1,Republican,Louie Gohmert,52,1200,373,1625
Harrison,19,U.S. House,1,Democratic,Shirley J. McKellar,20,219,89,328
Harrison,19,U.S. House,1,Libertarian,Phil Gray,0,25,10,35
Harrison,19,U.S. House,1,,Renee Culler (W),0,0,0,0
Harrison,19,Railroad Commissioner,,Republican,Wayne Christian,50,1168,348,1566
Harrison,19,Railroad Commissioner,,Democratic,Grady Yarbrough,18,208,91,317
Harrison,19,Railroad Commissioner,,Libertarian,Mark Miller,0,37,22,59
Harrison,19,Railroad Commissioner,,Green,Martina Salinas,0,9,10,19
Harrison,19,"Justice, Supreme Court, Place 3",,,Debra Lehrmann,48,1167,364,1579
Harrison,19,"Justice, Supreme Court, Place 3",,,Mike Westergren,19,212,85,316
Harrison,19,"Justice, Supreme Court, Place 3",,,Kathie Glass,1,29,15,45
Harrison,19,"Justice, Supreme Court, Place 3",,,Rodolfo Rivera Munoz,0,7,8,15
Harrison,19,"Justice, Supreme Court, Place 5",,,Paul Green,47,1169,363,1579
Harrison,19,"Justice, Supreme Court, Place 5",,,Dori Contreras Garza,19,207,82,308
Harrison,19,"Justice, Supreme Court, Place 5",,,Tom Oxford,2,32,16,50
Harrison,19,"Justice, Supreme Court, Place 5",,,Charles E. Waterbury,0,3,7,10
Harrison,19,"Justice, Supreme Court, Place 9",,,Eva Guzman,47,1147,353,1547
Harrison,19,"Justice, Supreme Court, Place 9",,,Savannah Robinson,20,209,83,312
Harrison,19,"Justice, Supreme Court, Place 9",,,Don Fulton,1,45,23,69
Harrison,19,"Justice, Supreme Court, Place 9",,,Jim Chisholm,0,7,7,14
Harrison,19,"Judge, Court of Criminal Appeals, Place 2",,,Mary Lou Keel,47,1162,355,1564
Harrison,19,"Judge, Court of Criminal Appeals, Place 2",,,"Lawrence ""Larry"" Meyers",21,215,89,325
Harrison,19,"Judge, Court of Criminal Appeals, Place 2",,,Mark Ash,0,30,18,48
Harrison,19,"Judge, Court of Criminal Appeals, Place 2",,,Adam King Blackwell Reposa,0,1,6,7
Harrison,19,"Judge, Court of Criminal Appeals, Place 5",,,Scott Walker,47,1178,365,1590
Harrison,19,"Judge, Court of Criminal Appeals, Place 5",,,Betsy Johnson,21,208,86,315
Harrison,19,"Judge, Court of Criminal Appeals, Place 5",,,"William Bryan Strange, III",0,22,10,32
Harrison,19,"Judge, Court of Criminal Appeals, Place 5",,,Judith Sanders-Castro,0,3,8,11
Harrison,19,"Judge, Court of Criminal Appeals, Place 6",,,Michael E. Keasler,48,1160,362,1570
Harrison,19,"Judge, Court of Criminal Appeals, Place 6",,,Robert Burns,20,210,92,322
Harrison,19,"Judge, Court of Criminal Appeals, Place 6",,,Mark W. Bennett,0,39,15,54
Harrison,19,"Member, State Board of Education, District 9",,,Keven M. Ellis,47,1152,357,1556
Harrison,19,"Member, State Board of Education, District 9",,,Amanda M. Rudolph,20,219,94,333
Harrison,19,"Member, State Board of Education, District 9",,,Anastasia Wilford,1,33,16,50
Harrison,19,State Senate,1,Republican,Bryan Hughes,58,1230,389,1677
Harrison,19,State Representative,9,Republican,Chris Paddie,57,1235,391,1683
Harrison,19,"Chief Justice, 6th Court of Appeals District",,,Josh Morriss,54,1227,388,1669
Harrison,19,"District Judge, 71st Judicial District",,,Brad Morin,55,1240,390,1685
Harrison,19,Sheriff,,,Tom McCool,56,1247,397,1700
Harrison,19,Tax Assessor-Collector,,,Veronica King,56,1249,393,1698
Harrison,19,"County Commissioner, Precinct No. 3",,,Phillip G. Mauldin,56,1248,388,1692
Harrison,19,"Constable, Precinct No. 3",,,Jim Weatherall,54,1242,393,1689
Harrison,19,Proposition County JP3,,,For,41,884,290,1215
Harrison,19,Proposition County JP3,,,Against,20,361,133,514
Harrison,20,Straight Party,,,Republican Party,28,441,221,690
Harrison,20,Straight Party,,,Democratic Party,10,117,89,216
Harrison,20,Straight Party,,,Libertarian Party,0,3,2,5
Harrison,20,Straight Party,,,Green Party,0,1,1,2
Harrison,20,President,,Republican,Donald J. Trump / Mike Pence,34,783,395,1212
Harrison,20,President,,Democratic,Hillary Clinton / Tim Kaine,21,185,124,330
Harrison,20,President,,Libertarian,Gary Johnson / William Weld,0,9,7,16
Harrison,20,President,,Green,Jill Stein / Ajamu Baraka,0,3,5,8
Harrison,20,President,,,Darrell L. Castle / Scott N. Bradley (W),1,0,0,1
Harrison,20,President,,,Scott Cubbler / Michael Rodriguez (W),0,0,0,0
Harrison,20,President,,,Cherunda Fox / Roger Kushner (W),0,0,0,0
Harrison,20,President,,,Tom Hoefling / Steve Schulin (W),0,0,0,0
Harrison,20,President,,,Laurence Kotlikoff / Edward Leamer (W),0,0,0,0
Harrison,20,President,,,Jonathan Lee / Jeffrey Erskine (W),0,0,0,0
Harrison,20,President,,,Michael A. Maturen / Juan A. Munoz (W),0,0,0,0
Harrison,20,President,,,Evan McMullin / Nathan Johnson (W),0,2,1,3
Harrison,20,President,,,Monica Moorehead / Lamon Lilly (W),0,0,0,0
Harrison,20,President,,,Robert Morrow / Todd Sanders (W),0,0,0,0
Harrison,20,President,,,Emidio Soltysik / Angela Walker (W),0,0,0,0
Harrison,20,President,,,Dale Steffes / Paul E. Case (W),0,0,0,0
Harrison,20,President,,,Tony Valdivia / Aaron Barriere (W),0,0,0,0
Harrison,20,U.S. House,1,Republican,Louie Gohmert,35,762,388,1185
Harrison,20,U.S. House,1,Democratic,Shirley J. McKellar,21,189,125,335
Harrison,20,U.S. House,1,Libertarian,Phil Gray,0,16,9,25
Harrison,20,U.S. House,1,,Renee Culler (W),0,1,0,1
Harrison,20,Railroad Commissioner,,Republican,Wayne Christian,36,743,374,1153
Harrison,20,Railroad Commissioner,,Democratic,Grady Yarbrough,19,181,124,324
Harrison,20,Railroad Commissioner,,Libertarian,Mark Miller,1,26,14,41
Harrison,20,Railroad Commissioner,,Green,Martina Salinas,0,14,7,21
Harrison,20,"Justice, Supreme Court, Place 3",,,Debra Lehrmann,37,740,378,1155
Harrison,20,"Justice, Supreme Court, Place 3",,,Mike Westergren,17,182,120,319
Harrison,20,"Justice, Supreme Court, Place 3",,,Kathie Glass,1,27,17,45
Harrison,20,"Justice, Supreme Court, Place 3",,,Rodolfo Rivera Munoz,0,8,4,12
Harrison,20,"Justice, Supreme Court, Place 5",,,Paul Green,37,741,386,1164
Harrison,20,"Justice, Supreme Court, Place 5",,,Dori Contreras Garza,16,187,116,319
Harrison,20,"Justice, Supreme Court, Place 5",,,Tom Oxford,1,22,10,33
Harrison,20,"Justice, Supreme Court, Place 5",,,Charles E. Waterbury,1,6,7,14
Harrison,20,"Justice, Supreme Court, Place 9",,,Eva Guzman,34,719,375,1128
Harrison,20,"Justice, Supreme Court, Place 9",,,Savannah Robinson,19,188,126,333
Harrison,20,"Justice, Supreme Court, Place 9",,,Don Fulton,2,32,11,45
Harrison,20,"Justice, Supreme Court, Place 9",,,Jim Chisholm,0,14,5,19
Harrison,20,"Judge, Court of Criminal Appeals, Place 2",,,Mary Lou Keel,36,737,371,1144
Harrison,20,"Judge, Court of Criminal Appeals, Place 2",,,"Lawrence ""Larry"" Meyers",20,188,127,335
Harrison,20,"Judge, Court of Criminal Appeals, Place 2",,,Mark Ash,0,28,15,43
Harrison,20,"Judge, Court of Criminal Appeals, Place 2",,,Adam King Blackwell Reposa,0,6,4,10
Harrison,20,"Judge, Court of Criminal Appeals, Place 5",,,Scott Walker,38,735,376,1149
Harrison,20,"Judge, Court of Criminal Appeals, Place 5",,,Betsy Johnson,16,195,128,339
Harrison,20,"Judge, Court of Criminal Appeals, Place 5",,,"William Bryan Strange, III",0,24,11,35
Harrison,20,"Judge, Court of Criminal Appeals, Place 5",,,Judith Sanders-Castro,1,5,4,10
Harrison,20,"Judge, Court of Criminal Appeals, Place 6",,,Michael E. Keasler,38,739,377,1154
Harrison,20,"Judge, Court of Criminal Appeals, Place 6",,,Robert Burns,16,188,120,324
Harrison,20,"Judge, Court of Criminal Appeals, Place 6",,,Mark W. Bennett,1,33,20,54
Harrison,20,"Member, State Board of Education, District 9",,,Keven M. Ellis,35,737,374,1146
Harrison,20,"Member, State Board of Education, District 9",,,Amanda M. Rudolph,20,196,126,342
Harrison,20,"Member, State Board of Education, District 9",,,Anastasia Wilford,1,24,16,41
Harrison,20,State Senate,1,Republican,Bryan Hughes,43,813,425,1281
Harrison,20,State Representative,9,Republican,Chris Paddie,43,814,424,1281
Harrison,20,"Chief Justice, 6th Court of Appeals District",,,Josh Morriss,43,808,422,1273
Harrison,20,"District Judge, 71st Judicial District",,,Brad Morin,44,812,422,1278
Harrison,20,Sheriff,,,Tom McCool,45,828,433,1306
Harrison,20,Tax Assessor-Collector,,,Veronica King,47,823,431,1301
Harrison,20,"County Commissioner, Precinct No. 1",,,William D. Hatfield,44,797,410,1251
Harrison,20,"Constable, Precinct No. 1",,,John C. Hickey Jr,44,814,426,1284
Harrison,20,"Trustee, Place 3 Karnack",,,Lacy D. Warren,0,3,0,3
Harrison,20,"Trustee, Place 3 Karnack",,,Jimmy P. Theodos,0,3,0,3
Harrison,21,Straight Party,,,Republican Party,9,118,60,187
Harrison,21,Straight Party,,,Democratic Party,13,65,15,93
Harrison,21,Straight Party,,,Libertarian Party,0,0,0,0
Harrison,21,Straight Party,,,Green Party,0,0,1,1
Harrison,21,President,,Republican,Donald J. Trump / Mike Pence,14,234,100,348
Harrison,21,President,,Democratic,Hillary Clinton / Tim Kaine,19,102,31,152
Harrison,21,President,,Libertarian,Gary Johnson / William Weld,0,3,2,5
Harrison,21,President,,Green,Jill Stein / Ajamu Baraka,0,0,1,1
Harrison,21,President,,,Darrell L. Castle / Scott N. Bradley (W),0,0,0,0
Harrison,21,President,,,Scott Cubbler / Michael Rodriguez (W),0,0,0,0
Harrison,21,President,,,Cherunda Fox / Roger Kushner (W),0,0,0,0
Harrison,21,President,,,Tom Hoefling / Steve Schulin (W),0,0,0,0
Harrison,21,President,,,Laurence Kotlikoff / Edward Leamer (W),0,0,0,0
Harrison,21,President,,,Jonathan Lee / Jeffrey Erskine (W),0,0,0,0
Harrison,21,President,,,Michael A. Maturen / Juan A. Munoz (W),0,0,0,0
Harrison,21,President,,,Evan McMullin / Nathan Johnson (W),0,1,0,1
Harrison,21,President,,,Monica Moorehead / Lamon Lilly (W),0,0,0,0
Harrison,21,President,,,Robert Morrow / Todd Sanders (W),0,0,0,0
Harrison,21,President,,,Emidio Soltysik / Angela Walker (W),0,0,0,0
Harrison,21,President,,,Dale Steffes / Paul E. Case (W),0,0,0,0
Harrison,21,President,,,Tony Valdivia / Aaron Barriere (W),0,0,0,0
Harrison,21,U.S. House,1,Republican,Louie Gohmert,14,229,98,341
Harrison,21,U.S. House,1,Democratic,Shirley J. McKellar,20,102,29,151
Harrison,21,U.S. House,1,Libertarian,Phil Gray,0,3,3,6
Harrison,21,U.S. House,1,,Renee Culler (W),0,0,0,0
Harrison,21,Railroad Commissioner,,Republican,Wayne Christian,13,212,96,321
Harrison,21,Railroad Commissioner,,Democratic,Grady Yarbrough,21,103,27,151
Harrison,21,Railroad Commissioner,,Libertarian,Mark Miller,0,8,5,13
Harrison,21,Railroad Commissioner,,Green,Martina Salinas,0,3,3,6
Harrison,21,"Justice, Supreme Court, Place 3",,,Debra Lehrmann,13,214,97,324
Harrison,21,"Justice, Supreme Court, Place 3",,,Mike Westergren,19,102,27,148
Harrison,21,"Justice, Supreme Court, Place 3",,,Kathie Glass,0,8,5,13
Harrison,21,"Justice, Supreme Court, Place 3",,,Rodolfo Rivera Munoz,1,1,2,4
Harrison,21,"Justice, Supreme Court, Place 5",,,Paul Green,14,223,97,334
Harrison,21,"Justice, Supreme Court, Place 5",,,Dori Contreras Garza,20,98,29,147
Harrison,21,"Justice, Supreme Court, Place 5",,,Tom Oxford,0,2,4,6
Harrison,21,"Justice, Supreme Court, Place 5",,,Charles E. Waterbury,0,1,1,2
Harrison,21,"Justice, Supreme Court, Place 9",,,Eva Guzman,14,212,97,323
Harrison,21,"Justice, Supreme Court, Place 9",,,Savannah Robinson,20,101,27,148
Harrison,21,"Justice, Supreme Court, Place 9",,,Don Fulton,0,8,5,13
Harrison,21,"Justice, Supreme Court, Place 9",,,Jim Chisholm,0,1,2,3
Harrison,21,"Judge, Court of Criminal Appeals, Place 2",,,Mary Lou Keel,14,211,99,324
Harrison,21,"Judge, Court of Criminal Appeals, Place 2",,,"Lawrence ""Larry"" Meyers",19,97,27,143
Harrison,21,"Judge, Court of Criminal Appeals, Place 2",,,Mark Ash,0,10,3,13
Harrison,21,"Judge, Court of Criminal Appeals, Place 2",,,Adam King Blackwell Reposa,1,1,1,3
Harrison,21,"Judge, Court of Criminal Appeals, Place 5",,,Scott Walker,14,213,98,325
Harrison,21,"Judge, Court of Criminal Appeals, Place 5",,,Betsy Johnson,19,104,26,149
Harrison,21,"Judge, Court of Criminal Appeals, Place 5",,,"William Bryan Strange, III",1,4,4,9
Harrison,21,"Judge, Court of Criminal Appeals, Place 5",,,Judith Sanders-Castro,0,2,2,4
Harrison,21,"Judge, Court of Criminal Appeals, Place 6",,,Michael E. Keasler,14,215,99,328
Harrison,21,"Judge, Court of Criminal Appeals, Place 6",,,Robert Burns,20,102,26,148
Harrison,21,"Judge, Court of Criminal Appeals, Place 6",,,Mark W. Bennett,0,5,5,10
Harrison,21,"Member, State Board of Education, District 9",,,Keven M. Ellis,14,212,99,325
Harrison,21,"Member, State Board of Education, District 9",,,Amanda M. Rudolph,20,104,28,152
Harrison,21,"Member, State Board of Education, District 9",,,Anastasia Wilford,0,6,5,11
Harrison,21,State Senate,1,Republican,Bryan Hughes,17,235,108,360
Harrison,21,State Representative,9,Republican,Chris Paddie,17,242,111,370
Harrison,21,"Chief Justice, 6th Court of Appeals District",,,Josh Morriss,17,233,106,356
Harrison,21,"District Judge, 71st Judicial District",,,Brad Morin,17,240,108,365
Harrison,21,Sheriff,,,Tom McCool,17,245,110,372
Harrison,21,Tax Assessor-Collector,,,Veronica King,20,250,111,381
Harrison,21,"County Commissioner, Precinct No. 1",,,William D. Hatfield,18,233,103,354
Harrison,21,"Constable, Precinct No. 1",,,John C. Hickey Jr,17,223,103,343
Harrison,22,Straight Party,,,Republican Party,27,178,38,243
Harrison,22,Straight Party,,,Democratic Party,43,248,88,379
Harrison,22,Straight Party,,,Libertarian Party,0,1,1,2
Harrison,22,Straight Party,,,Green Party,0,1,0,1
Harrison,22,President,,Republican,Donald J. Trump / Mike Pence,45,321,71,437
Harrison,22,President,,Democratic,Hillary Clinton / Tim Kaine,56,407,141,604
Harrison,22,President,,Libertarian,Gary Johnson / William Weld,0,12,5,17
Harrison,22,President,,Green,Jill Stein / Ajamu Baraka,0,2,0,2
Harrison,22,President,,,Darrell L. Castle / Scott N. Bradley (W),0,0,0,0
Harrison,22,President,,,Scott Cubbler / Michael Rodriguez (W),0,0,0,0
Harrison,22,President,,,Cherunda Fox / Roger Kushner (W),0,0,0,0
Harrison,22,President,,,Tom Hoefling / Steve Schulin (W),0,0,0,0
Harrison,22,President,,,Laurence Kotlikoff / Edward Leamer (W),0,0,0,0
Harrison,22,President,,,Jonathan Lee / Jeffrey Erskine (W),0,0,0,0
Harrison,22,President,,,Michael A. Maturen / Juan A. Munoz (W),0,0,0,0
Harrison,22,President,,,Evan McMullin / Nathan Johnson (W),0,0,2,2
Harrison,22,President,,,Monica Moorehead / Lamon Lilly (W),0,0,0,0
Harrison,22,President,,,Robert Morrow / Todd Sanders (W),0,0,0,0
Harrison,22,President,,,Emidio Soltysik / Angela Walker (W),0,0,0,0
Harrison,22,President,,,Dale Steffes / Paul E. Case (W),0,0,0,0
Harrison,22,President,,,Tony Valdivia / Aaron Barriere (W),0,0,0,0
Harrison,22,U.S. House,1,Republican,Louie Gohmert,46,326,74,446
Harrison,22,U.S. House,1,Democratic,Shirley J. McKellar,51,388,130,569
Harrison,22,U.S. House,1,Libertarian,Phil Gray,0,15,6,21
Harrison,22,U.S. House,1,,Renee Culler (W),0,0,0,0
Harrison,22,Railroad Commissioner,,Republican,Wayne Christian,38,312,63,413
Harrison,22,Railroad Commissioner,,Democratic,Grady Yarbrough,54,372,130,556
Harrison,22,Railroad Commissioner,,Libertarian,Mark Miller,0,20,9,29
Harrison,22,Railroad Commissioner,,Green,Martina Salinas,0,18,8,26
Harrison,22,"Justice, Supreme Court, Place 3",,,Debra Lehrmann,38,310,70,418
Harrison,22,"Justice, Supreme Court, Place 3",,,Mike Westergren,53,378,128,559
Harrison,22,"Justice, Supreme Court, Place 3",,,Kathie Glass,1,19,8,28
Harrison,22,"Justice, Supreme Court, Place 3",,,Rodolfo Rivera Munoz,0,12,5,17
Harrison,22,"Justice, Supreme Court, Place 5",,,Paul Green,40,311,66,417
Harrison,22,"Justice, Supreme Court, Place 5",,,Dori Contreras Garza,51,382,132,565
Harrison,22,"Justice, Supreme Court, Place 5",,,Tom Oxford,1,19,7,27
Harrison,22,"Justice, Supreme Court, Place 5",,,Charles E. Waterbury,1,6,5,12
Harrison,22,"Justice, Supreme Court, Place 9",,,Eva Guzman,40,304,65,409
Harrison,22,"Justice, Supreme Court, Place 9",,,Savannah Robinson,51,385,135,571
Harrison,22,"Justice, Supreme Court, Place 9",,,Don Fulton,2,15,5,22
Harrison,22,"Justice, Supreme Court, Place 9",,,Jim Chisholm,1,10,3,14
Harrison,22,"Judge, Court of Criminal Appeals, Place 2",,,Mary Lou Keel,37,318,73,428
Harrison,22,"Judge, Court of Criminal Appeals, Place 2",,,"Lawrence ""Larry"" Meyers",52,373,133,558
Harrison,22,"Judge, Court of Criminal Appeals, Place 2",,,Mark Ash,2,19,3,24
Harrison,22,"Judge, Court of Criminal Appeals, Place 2",,,Adam King Blackwell Reposa,1,8,1,10
Harrison,22,"Judge, Court of Criminal Appeals, Place 5",,,Scott Walker,39,307,67,413
Harrison,22,"Judge, Court of Criminal Appeals, Place 5",,,Betsy Johnson,54,382,134,570
Harrison,22,"Judge, Court of Criminal Appeals, Place 5",,,"William Bryan Strange, III",0,20,5,25
Harrison,22,"Judge, Court of Criminal Appeals, Place 5",,,Judith Sanders-Castro,0,10,4,14
Harrison,22,"Judge, Court of Criminal Appeals, Place 6",,,Michael E. Keasler,38,311,66,415
Harrison,22,"Judge, Court of Criminal Appeals, Place 6",,,Robert Burns,52,388,136,576
Harrison,22,"Judge, Court of Criminal Appeals, Place 6",,,Mark W. Bennett,1,20,8,29
Harrison,22,"Member, State Board of Education, District 9",,,Keven M. Ellis,39,302,63,404
Harrison,22,"Member, State Board of Education, District 9",,,Amanda M. Rudolph,55,397,136,588
Harrison,22,"Member, State Board of Education, District 9",,,Anastasia Wilford,1,20,10,31
Harrison,22,State Senate,1,Republican,Bryan Hughes,52,408,106,566
Harrison,22,State Representative,9,Republican,Chris Paddie,51,419,105,575
Harrison,22,"Chief Justice, 6th Court of Appeals District",,,Josh Morriss,47,393,104,544
Harrison,22,"District Judge, 71st Judicial District",,,Brad Morin,53,429,106,588
Harrison,22,Sheriff,,,Tom McCool,56,430,113,599
Harrison,22,Tax Assessor-Collector,,,Veronica King,54,437,114,605
Harrison,22,"Constable, Precinct No. 2",,,Brant Moore,65,488,167,720
Harrison,23,Straight Party,,,Republican Party,7,135,59,201
Harrison,23,Straight Party,,,Democratic Party,2,8,1,11
Harrison,23,Straight Party,,,Libertarian Party,0,0,0,0
Harrison,23,Straight Party,,,Green Party,0,0,0,0
Harrison,23,President,,Republican,Donald J. Trump / Mike Pence,10,202,106,318
Harrison,23,President,,Democratic,Hillary Clinton / Tim Kaine,3,12,4,19
Harrison,23,President,,Libertarian,Gary Johnson / William Weld,0,0,1,1
Harrison,23,President,,Green,Jill Stein / Ajamu Baraka,0,0,0,0
Harrison,23,President,,,Darrell L. Castle / Scott N. Bradley (W),0,0,0,0
Harrison,23,President,,,Scott Cubbler / Michael Rodriguez (W),0,0,0,0
Harrison,23,President,,,Cherunda Fox / Roger Kushner (W),0,0,0,0
Harrison,23,President,,,Tom Hoefling / Steve Schulin (W),0,0,0,0
Harrison,23,President,,,Laurence Kotlikoff / Edward Leamer (W),0,0,0,0
Harrison,23,President,,,Jonathan Lee / Jeffrey Erskine (W),0,0,0,0
Harrison,23,President,,,Michael A. Maturen / Juan A. Munoz (W),0,0,0,0
Harrison,23,President,,,Evan McMullin / Nathan Johnson (W),0,0,0,0
Harrison,23,President,,,Monica Moorehead / Lamon Lilly (W),0,0,0,0
Harrison,23,President,,,Robert Morrow / Todd Sanders (W),0,0,0,0
Harrison,23,President,,,Emidio Soltysik / Angela Walker (W),0,0,0,0
Harrison,23,President,,,Dale Steffes / Paul E. Case (W),0,0,0,0
Harrison,23,President,,,Tony Valdivia / Aaron Barriere (W),0,0,0,0
Harrison,23,U.S. House,1,Republican,Louie Gohmert,12,203,107,322
Harrison,23,U.S. House,1,Democratic,Shirley J. McKellar,2,11,1,14
Harrison,23,U.S. House,1,Libertarian,Phil Gray,0,0,3,3
Harrison,23,U.S. House,1,,Renee Culler (W),0,0,0,0
Harrison,23,Railroad Commissioner,,Republican,Wayne Christian,12,198,102,312
Harrison,23,Railroad Commissioner,,Democratic,Grady Yarbrough,2,14,4,20
Harrison,23,Railroad Commissioner,,Libertarian,Mark Miller,0,1,3,4
Harrison,23,Railroad Commissioner,,Green,Martina Salinas,0,0,0,0
Harrison,23,"Justice, Supreme Court, Place 3",,,Debra Lehrmann,12,200,100,312
Harrison,23,"Justice, Supreme Court, Place 3",,,Mike Westergren,2,12,3,17
Harrison,23,"Justice, Supreme Court, Place 3",,,Kathie Glass,0,2,5,7
Harrison,23,"Justice, Supreme Court, Place 3",,,Rodolfo Rivera Munoz,0,0,2,2
Harrison,23,"Justice, Supreme Court, Place 5",,,Paul Green,12,199,104,315
Harrison,23,"Justice, Supreme Court, Place 5",,,Dori Contreras Garza,2,13,2,17
Harrison,23,"Justice, Supreme Court, Place 5",,,Tom Oxford,0,0,3,3
Harrison,23,"Justice, Supreme Court, Place 5",,,Charles E. Waterbury,0,0,0,0
Harrison,23,"Justice, Supreme Court, Place 9",,,Eva Guzman,12,196,101,309
Harrison,23,"Justice, Supreme Court, Place 9",,,Savannah Robinson,2,13,3,18
Harrison,23,"Justice, Supreme Court, Place 9",,,Don Fulton,0,1,5,6
Harrison,23,"Justice, Supreme Court, Place 9",,,Jim Chisholm,0,1,1,2
Harrison,23,"Judge, Court of Criminal Appeals, Place 2",,,Mary Lou Keel,12,199,102,313
Harrison,23,"Judge, Court of Criminal Appeals, Place 2",,,"Lawrence ""Larry"" Meyers",2,11,2,15
Harrison,23,"Judge, Court of Criminal Appeals, Place 2",,,Mark Ash,0,3,5,8
Harrison,23,"Judge, Court of Criminal Appeals, Place 2",,,Adam King Blackwell Reposa,0,0,0,0
Harrison,23,"Judge, Court of Criminal Appeals, Place 5",,,Scott Walker,12,198,102,312
Harrison,23,"Judge, Court of Criminal Appeals, Place 5",,,Betsy Johnson,2,14,3,19
Harrison,23,"Judge, Court of Criminal Appeals, Place 5",,,"William Bryan Strange, III",0,1,4,5
Harrison,23,"Judge, Court of Criminal Appeals, Place 5",,,Judith Sanders-Castro,0,0,0,0
Harrison,23,"Judge, Court of Criminal Appeals, Place 6",,,Michael E. Keasler,12,199,100,311
Harrison,23,"Judge, Court of Criminal Appeals, Place 6",,,Robert Burns,2,14,3,19
Harrison,23,"Judge, Court of Criminal Appeals, Place 6",,,Mark W. Bennett,0,0,5,5
Harrison,23,"Member, State Board of Education, District 9",,,Keven M. Ellis,12,194,98,304
Harrison,23,"Member, State Board of Education, District 9",,,Amanda M. Rudolph,2,14,3,19
Harrison,23,"Member, State Board of Education, District 9",,,Anastasia Wilford,0,3,5,8
Harrison,23,State Senate,1,Republican,Bryan Hughes,12,198,106,316
Harrison,23,State Representative,9,Republican,Chris Paddie,12,202,102,316
Harrison,23,"Chief Justice, 6th Court of Appeals District",,,Josh Morriss,12,202,102,316
Harrison,23,"District Judge, 71st Judicial District",,,Brad Morin,12,200,102,314
Harrison,23,Sheriff,,,Tom McCool,12,200,104,316
Harrison,23,Tax Assessor-Collector,,,Veronica King,12,202,102,316
Harrison,23,"Justice of the Peace, Precinct No. 4 - Unexpired Term",,,Nancy Schnorbus George,13,198,100,311
Harrison,23,"Constable, Precinct No. 4",,,Darryl Griffin,12,198,104,314
Harrison,23,"Trustee, Place 1 Harleton",,,Charlie Mangham,0,9,11,20
Harrison,23,"Trustee, Place 1 Harleton",,,Kevin Wright,2,48,27,77
Harrison,23,"Trustee, Place 2 Harleton",,,Brad Nixon,0,36,26,62
Harrison,23,"Trustee, Place 2 Harleton",,,Randy Pilkington,1,20,11,32
Harrison,23,"Trustee, Place 3 Harleton",,,Mike Bullock,2,51,34,87
Harrison,23,"Trustee, Place 5 Harleton",,,Brian Degner,2,50,34,86
Harrison,23,"Trustee, Place 6 Harleton",,,Pat McGill,0,37,23,60
Harrison,23,"Trustee, Place 6 Harleton",,,Paul D. Wilson,2,18,15,35
Harrison,24,Straight Party,,,Republican Party,4,112,38,154
Harrison,24,Straight Party,,,Democratic Party,0,27,12,39
Harrison,24,Straight Party,,,Libertarian Party,0,0,0,0
Harrison,24,Straight Party,,,Green Party,0,0,0,0
Harrison,24,President,,Republican,Donald J. Trump / Mike Pence,7,200,86,293
Harrison,24,President,,Democratic,Hillary Clinton / Tim Kaine,1,44,17,62
Harrison,24,President,,Libertarian,Gary Johnson / William Weld,1,2,2,5
Harrison,24,President,,Green,Jill Stein / Ajamu Baraka,0,0,1,1
Harrison,24,President,,,Darrell L. Castle / Scott N. Bradley (W),0,0,0,0
Harrison,24,President,,,Scott Cubbler / Michael Rodriguez (W),0,0,0,0
Harrison,24,President,,,Cherunda Fox / Roger Kushner (W),0,0,0,0
Harrison,24,President,,,Tom Hoefling / Steve Schulin (W),0,0,0,0
Harrison,24,President,,,Laurence Kotlikoff / Edward Leamer (W),0,0,0,0
Harrison,24,President,,,Jonathan Lee / Jeffrey Erskine (W),0,0,0,0
Harrison,24,President,,,Michael A. Maturen / Juan A. Munoz (W),0,0,0,0
Harrison,24,President,,,Evan McMullin / Nathan Johnson (W),0,1,0,1
Harrison,24,President,,,Monica Moorehead / Lamon Lilly (W),0,0,0,0
Harrison,24,President,,,Robert Morrow / Todd Sanders (W),0,0,0,0
Harrison,24,President,,,Emidio Soltysik / Angela Walker (W),0,0,0,0
Harrison,24,President,,,Dale Steffes / Paul E. Case (W),0,0,0,0
Harrison,24,President,,,Tony Valdivia / Aaron Barriere (W),0,0,0,0
Harrison,24,U.S. House,1,Republican,Louie Gohmert,8,199,89,296
Harrison,24,U.S. House,1,Democratic,Shirley J. McKellar,1,42,16,59
Harrison,24,U.S. House,1,Libertarian,Phil Gray,0,1,0,1
Harrison,24,U.S. House,1,,Renee Culler (W),0,0,0,0
Harrison,24,Railroad Commissioner,,Republican,Wayne Christian,8,193,77,278
Harrison,24,Railroad Commissioner,,Democratic,Grady Yarbrough,1,44,21,66
Harrison,24,Railroad Commissioner,,Libertarian,Mark Miller,0,3,4,7
Harrison,24,Railroad Commissioner,,Green,Martina Salinas,0,1,2,3
Harrison,24,"Justice, Supreme Court, Place 3",,,Debra Lehrmann,6,192,78,276
Harrison,24,"Justice, Supreme Court, Place 3",,,Mike Westergren,3,44,21,68
Harrison,24,"Justice, Supreme Court, Place 3",,,Kathie Glass,0,4,3,7
Harrison,24,"Justice, Supreme Court, Place 3",,,Rodolfo Rivera Munoz,0,1,1,2
Harrison,24,"Justice, Supreme Court, Place 5",,,Paul Green,8,192,82,282
Harrison,24,"Justice, Supreme Court, Place 5",,,Dori Contreras Garza,1,43,18,62
Harrison,24,"Justice, Supreme Court, Place 5",,,Tom Oxford,0,0,1,1
Harrison,24,"Justice, Supreme Court, Place 5",,,Charles E. Waterbury,0,2,1,3
Harrison,24,"Justice, Supreme Court, Place 9",,,Eva Guzman,6,189,81,276
Harrison,24,"Justice, Supreme Court, Place 9",,,Savannah Robinson,2,46,20,68
Harrison,24,"Justice, Supreme Court, Place 9",,,Don Fulton,1,3,1,5
Harrison,24,"Justice, Supreme Court, Place 9",,,Jim Chisholm,0,0,0,0
Harrison,24,"Judge, Court of Criminal Appeals, Place 2",,,Mary Lou Keel,6,191,86,283
Harrison,24,"Judge, Court of Criminal Appeals, Place 2",,,"Lawrence ""Larry"" Meyers",2,45,16,63
Harrison,24,"Judge, Court of Criminal Appeals, Place 2",,,Mark Ash,1,2,1,4
Harrison,24,"Judge, Court of Criminal Appeals, Place 2",,,Adam King Blackwell Reposa,0,0,1,1
Harrison,24,"Judge, Court of Criminal Appeals, Place 5",,,Scott Walker,8,189,82,279
Harrison,24,"Judge, Court of Criminal Appeals, Place 5",,,Betsy Johnson,1,48,19,68
Harrison,24,"Judge, Court of Criminal Appeals, Place 5",,,"William Bryan Strange, III",0,0,3,3
Harrison,24,"Judge, Court of Criminal Appeals, Place 5",,,Judith Sanders-Castro,0,0,0,0
Harrison,24,"Judge, Court of Criminal Appeals, Place 6",,,Michael E. Keasler,8,191,82,281
Harrison,24,"Judge, Court of Criminal Appeals, Place 6",,,Robert Burns,1,43,19,63
Harrison,24,"Judge, Court of Criminal Appeals, Place 6",,,Mark W. Bennett,0,4,2,6
Harrison,24,"Member, State Board of Education, District 9",,,Keven M. Ellis,8,189,82,279
Harrison,24,"Member, State Board of Education, District 9",,,Amanda M. Rudolph,1,43,19,63
Harrison,24,"Member, State Board of Education, District 9",,,Anastasia Wilford,0,3,1,4
Harrison,24,State Senate,1,Republican,Bryan Hughes,8,202,86,296
Harrison,24,State Representative,9,Republican,Chris Paddie,8,199,87,294
Harrison,24,"Chief Justice, 6th Court of Appeals District",,,Josh Morriss,8,199,83,290
Harrison,24,"District Judge, 71st Judicial District",,,Brad Morin,8,205,86,299
Harrison,24,Sheriff,,,Tom McCool,8,204,86,298
Harrison,24,Tax Assessor-Collector,,,Veronica King,7,210,86,303
Harrison,24,"Justice of the Peace, Precinct No. 4 - Unexpired Term",,,Nancy Schnorbus George,8,207,87,302
Harrison,24,"Constable, Precinct No. 4",,,Darryl Griffin,8,201,85,294
Harrison,24,"Trustee, Place 1 Harleton",,,Charlie Mangham,4,54,34,92
Harrison,24,"Trustee, Place 1 Harleton",,,Kevin Wright,2,128,43,173
Harrison,24,"Trustee, Place 2 Harleton",,,Brad Nixon,4,78,38,120
Harrison,24,"Trustee, Place 2 Harleton",,,Randy Pilkington,2,107,41,150
Harrison,24,"Trustee, Place 3 Harleton",,,Mike Bullock,5,148,61,214
Harrison,24,"Trustee, Place 5 Harleton",,,Brian Degner,5,153,61,219
Harrison,24,"Trustee, Place 6 Harleton",,,Pat McGill,4,121,54,179
Harrison,24,"Trustee, Place 6 Harleton",,,Paul D. Wilson,2,63,25,90
Harrison,25,Straight Party,,,Republican Party,56,830,188,1074
Harrison,25,Straight Party,,,Democratic Party,10,102,28,140
Harrison,25,Straight Party,,,Libertarian Party,0,11,3,14
Harrison,25,Straight Party,,,Green Party,0,0,1,1
Harrison,25,President,,Republican,Donald J. Trump / Mike Pence,83,1479,322,1884
Harrison,25,President,,Democratic,Hillary Clinton / Tim Kaine,20,209,66,295
Harrison,25,President,,Libertarian,Gary Johnson / William Weld,4,42,13,59
Harrison,25,President,,Green,Jill Stein / Ajamu Baraka,0,1,3,4
Harrison,25,President,,,Darrell L. Castle / Scott N. Bradley (W),0,1,0,1
Harrison,25,President,,,Scott Cubbler / Michael Rodriguez (W),0,1,0,1
Harrison,25,President,,,Cherunda Fox / Roger Kushner (W),0,0,0,0
Harrison,25,President,,,Tom Hoefling / Steve Schulin (W),0,4,0,4
Harrison,25,President,,,Laurence Kotlikoff / Edward Leamer (W),0,0,0,0
Harrison,25,President,,,Jonathan Lee / Jeffrey Erskine (W),0,0,0,0
Harrison,25,President,,,Michael A. Maturen / Juan A. Munoz (W),0,0,0,0
Harrison,25,President,,,Evan McMullin / Nathan Johnson (W),0,8,1,9
Harrison,25,President,,,Monica Moorehead / Lamon Lilly (W),0,0,0,0
Harrison,25,President,,,Robert Morrow / Todd Sanders (W),0,0,0,0
Harrison,25,President,,,Emidio Soltysik / Angela Walker (W),0,0,1,1
Harrison,25,President,,,Dale Steffes / Paul E. Case (W),0,0,0,0
Harrison,25,President,,,Tony Valdivia / Aaron Barriere (W),0,0,0,0
Harrison,25,U.S. House,1,Republican,Louie Gohmert,86,1503,329,1918
Harrison,25,U.S. House,1,Democratic,Shirley J. McKellar,20,200,63,283
Harrison,25,U.S. House,1,Libertarian,Phil Gray,1,38,15,54
Harrison,25,U.S. House,1,,Renee Culler (W),0,0,0,0
Harrison,25,Railroad Commissioner,,Republican,Wayne Christian,79,1440,316,1835
Harrison,25,Railroad Commissioner,,Democratic,Grady Yarbrough,19,193,56,268
Harrison,25,Railroad Commissioner,,Libertarian,Mark Miller,4,63,25,92
Harrison,25,Railroad Commissioner,,Green,Martina Salinas,1,12,6,19
Harrison,25,"Justice, Supreme Court, Place 3",,,Debra Lehrmann,79,1445,324,1848
Harrison,25,"Justice, Supreme Court, Place 3",,,Mike Westergren,20,205,57,282
Harrison,25,"Justice, Supreme Court, Place 3",,,Kathie Glass,4,47,20,71
Harrison,25,"Justice, Supreme Court, Place 3",,,Rodolfo Rivera Munoz,0,10,5,15
Harrison,25,"Justice, Supreme Court, Place 5",,,Paul Green,83,1446,321,1850
Harrison,25,"Justice, Supreme Court, Place 5",,,Dori Contreras Garza,18,197,66,281
Harrison,25,"Justice, Supreme Court, Place 5",,,Tom Oxford,2,50,14,66
Harrison,25,"Justice, Supreme Court, Place 5",,,Charles E. Waterbury,0,9,3,12
Harrison,25,"Justice, Supreme Court, Place 9",,,Eva Guzman,80,1438,314,1832
Harrison,25,"Justice, Supreme Court, Place 9",,,Savannah Robinson,19,201,63,283
Harrison,25,"Justice, Supreme Court, Place 9",,,Don Fulton,4,47,21,72
Harrison,25,"Justice, Supreme Court, Place 9",,,Jim Chisholm,0,12,5,17
Harrison,25,"Judge, Court of Criminal Appeals, Place 2",,,Mary Lou Keel,79,1429,320,1828
Harrison,25,"Judge, Court of Criminal Appeals, Place 2",,,"Lawrence ""Larry"" Meyers",20,207,62,289
Harrison,25,"Judge, Court of Criminal Appeals, Place 2",,,Mark Ash,4,52,18,74
Harrison,25,"Judge, Court of Criminal Appeals, Place 2",,,Adam King Blackwell Reposa,0,3,4,7
Harrison,25,"Judge, Court of Criminal Appeals, Place 5",,,Scott Walker,82,1450,323,1855
Harrison,25,"Judge, Court of Criminal Appeals, Place 5",,,Betsy Johnson,19,201,64,284
Harrison,25,"Judge, Court of Criminal Appeals, Place 5",,,"William Bryan Strange, III",2,35,11,48
Harrison,25,"Judge, Court of Criminal Appeals, Place 5",,,Judith Sanders-Castro,0,8,5,13
Harrison,25,"Judge, Court of Criminal Appeals, Place 6",,,Michael E. Keasler,82,1454,326,1862
Harrison,25,"Judge, Court of Criminal Appeals, Place 6",,,Robert Burns,19,203,58,280
Harrison,25,"Judge, Court of Criminal Appeals, Place 6",,,Mark W. Bennett,2,42,17,61
Harrison,25,"Member, State Board of Education, District 9",,,Keven M. Ellis,80,1439,318,1837
Harrison,25,"Member, State Board of Education, District 9",,,Amanda M. Rudolph,22,218,62,302
Harrison,25,"Member, State Board of Education, District 9",,,Anastasia Wilford,2,43,22,67
Harrison,25,State Senate,1,Republican,Bryan Hughes,92,1518,359,1969
Harrison,25,State Representative,9,Republican,Chris Paddie,91,1524,362,1977
Harrison,25,"Chief Justice, 6th Court of Appeals District",,,Josh Morriss,91,1512,361,1964
Harrison,25,"District Judge, 71st Judicial District",,,Brad Morin,91,1508,361,1960
Harrison,25,Sheriff,,,Tom McCool,94,1521,369,1984
Harrison,25,Tax Assessor-Collector,,,Veronica King,93,1529,364,1986
Harrison,25,"County Commissioner, Precinct No. 3",,,Phillip G. Mauldin,91,1532,367,1990
Harrison,25,"Constable, Precinct No. 3",,,Jim Weatherall,91,1520,365,1976
Harrison,25,Proposition County JP3,,,For,48,957,262,1267
Harrison,25,Proposition County JP3,,,Against,47,534,96,677
Harrison,26,Straight Party,,,Republican Party,8,134,17,159
Harrison,26,Straight Party,,,Democratic Party,2,23,8,33
Harrison,26,Straight Party,,,Libertarian Party,0,0,0,0
Harrison,26,Straight Party,,,Green Party,0,0,0,0
Harrison,26,President,,Republican,Donald J. Trump / Mike Pence,11,260,32,303
Harrison,26,President,,Democratic,Hillary Clinton / Tim Kaine,4,40,15,59
Harrison,26,President,,Libertarian,Gary Johnson / William Weld,0,3,0,3
Harrison,26,President,,Green,Jill Stein / Ajamu Baraka,0,0,0,0
Harrison,26,President,,,Darrell L. Castle / Scott N. Bradley (W),0,0,0,0
Harrison,26,President,,,Scott Cubbler / Michael Rodriguez (W),0,0,0,0
Harrison,26,President,,,Cherunda Fox / Roger Kushner (W),0,0,0,0
Harrison,26,President,,,Tom Hoefling / Steve Schulin (W),0,0,0,0
Harrison,26,President,,,Laurence Kotlikoff / Edward Leamer (W),0,0,0,0
Harrison,26,President,,,Jonathan Lee / Jeffrey Erskine (W),0,0,0,0
Harrison,26,President,,,Michael A. Maturen / Juan A. Munoz (W),0,0,0,0
Harrison,26,President,,,Evan McMullin / Nathan Johnson (W),0,0,0,0
Harrison,26,President,,,Monica Moorehead / Lamon Lilly (W),0,0,0,0
Harrison,26,President,,,Robert Morrow / Todd Sanders (W),0,0,0,0
Harrison,26,President,,,Emidio Soltysik / Angela Walker (W),0,0,0,0
Harrison,26,President,,,Dale Steffes / Paul E. Case (W),0,0,0,0
Harrison,26,President,,,Tony Valdivia / Aaron Barriere (W),0,0,0,0
Harrison,26,U.S. House,1,Republican,Louie Gohmert,11,249,33,293
Harrison,26,U.S. House,1,Democratic,Shirley J. McKellar,5,42,14,61
Harrison,26,U.S. House,1,Libertarian,Phil Gray,0,8,1,9
Harrison,26,U.S. House,1,,Renee Culler (W),0,0,0,0
Harrison,26,Railroad Commissioner,,Republican,Wayne Christian,11,248,32,291
Harrison,26,Railroad Commissioner,,Democratic,Grady Yarbrough,3,42,14,59
Harrison,26,Railroad Commissioner,,Libertarian,Mark Miller,1,6,1,8
Harrison,26,Railroad Commissioner,,Green,Martina Salinas,1,1,1,3
Harrison,26,"Justice, Supreme Court, Place 3",,,Debra Lehrmann,12,246,32,290
Harrison,26,"Justice, Supreme Court, Place 3",,,Mike Westergren,3,44,13,60
Harrison,26,"Justice, Supreme Court, Place 3",,,Kathie Glass,1,4,2,7
Harrison,26,"Justice, Supreme Court, Place 3",,,Rodolfo Rivera Munoz,0,1,1,2
Harrison,26,"Justice, Supreme Court, Place 5",,,Paul Green,11,249,32,292
Harrison,26,"Justice, Supreme Court, Place 5",,,Dori Contreras Garza,5,42,16,63
Harrison,26,"Justice, Supreme Court, Place 5",,,Tom Oxford,0,4,0,4
Harrison,26,"Justice, Supreme Court, Place 5",,,Charles E. Waterbury,0,0,0,0
Harrison,26,"Justice, Supreme Court, Place 9",,,Eva Guzman,12,239,32,283
Harrison,26,"Justice, Supreme Court, Place 9",,,Savannah Robinson,4,42,15,61
Harrison,26,"Justice, Supreme Court, Place 9",,,Don Fulton,0,8,1,9
Harrison,26,"Justice, Supreme Court, Place 9",,,Jim Chisholm,0,4,0,4
Harrison,26,"Judge, Court of Criminal Appeals, Place 2",,,Mary Lou Keel,12,246,32,290
Harrison,26,"Judge, Court of Criminal Appeals, Place 2",,,"Lawrence ""Larry"" Meyers",4,43,14,61
Harrison,26,"Judge, Court of Criminal Appeals, Place 2",,,Mark Ash,0,5,2,7
Harrison,26,"Judge, Court of Criminal Appeals, Place 2",,,Adam King Blackwell Reposa,0,1,0,1
Harrison,26,"Judge, Court of Criminal Appeals, Place 5",,,Scott Walker,11,247,33,291
Harrison,26,"Judge, Court of Criminal Appeals, Place 5",,,Betsy Johnson,4,46,14,64
Harrison,26,"Judge, Court of Criminal Appeals, Place 5",,,"William Bryan Strange, III",0,2,0,2
Harrison,26,"Judge, Court of Criminal Appeals, Place 5",,,Judith Sanders-Castro,1,0,1,2
Harrison,26,"Judge, Court of Criminal Appeals, Place 6",,,Michael E. Keasler,11,245,33,289
Harrison,26,"Judge, Court of Criminal Appeals, Place 6",,,Robert Burns,4,45,15,64
Harrison,26,"Judge, Court of Criminal Appeals, Place 6",,,Mark W. Bennett,1,5,0,6
Harrison,26,"Member, State Board of Education, District 9",,,Keven M. Ellis,11,244,31,286
Harrison,26,"Member, State Board of Education, District 9",,,Amanda M. Rudolph,4,42,16,62
Harrison,26,"Member, State Board of Education, District 9",,,Anastasia Wilford,1,5,1,7
Harrison,26,State Senate,1,Republican,Bryan Hughes,11,256,40,307
Harrison,26,State Representative,9,Republican,Chris Paddie,12,263,40,315
Harrison,26,"Chief Justice, 6th Court of Appeals District",,,Josh Morriss,12,258,40,310
Harrison,26,"District Judge, 71st Judicial District",,,Brad Morin,12,265,40,317
Harrison,26,Sheriff,,,Tom McCool,12,273,40,325
Harrison,26,Tax Assessor-Collector,,,Veronica King,12,264,40,316
Harrison,26,"County Commissioner, Precinct No. 1",,,William D. Hatfield,12,264,39,315
Harrison,26,"Constable, Precinct No. 1",,,John C. Hickey Jr,12,253,35,300
